8/23/1997,Northwestern,24,Oklahoma,0,24
8/24/1997,Syracuse,34,Wisconsin,0,34
8/28/1997,C Michigan,44,N Illinois,10,34
8/28/1997,Cincinnati,34,Tulsa,24,10
8/28/1997,Kansas,24,UAB,0,24
8/28/1997,Ohio,31,Kent,7,24
8/28/1997,Ohio St,24,Wyoming,10,14
8/28/1997,W Michigan,34,Temple,14,20
8/30/1997,Air Force,14,Idaho,10,4
8/30/1997,Alabama,42,Houston,17,25
8/30/1997,Arizona St,41,New Mexico St,10,31
8/30/1997,CS Northridge,63,Boise St,23,40
8/30/1997,Colorado St,45,Nevada,13,32
8/30/1997,Florida,21,Southern Miss,6,15
8/30/1997,Fresno St,35,Portland St,7,28
8/30/1997,Georgia,38,Arkansas St,7,31
8/30/1997,Hawaii,17,Minnesota,3,14
8/30/1997,Kentucky,38,Louisville,24,14
8/30/1997,Louisiana Tech,30,Bowling Green,23,7
8/30/1997,Miami FL,45,Baylor,14,31
8/30/1997,Miami OH,27,Ball St,10,17
8/30/1997,Mississippi,24,UCF,23,1
8/30/1997,Mississippi St,13,Memphis,10,3
8/30/1997,Nebraska,59,Akron,14,45
8/30/1997,New Mexico,33,Northern Arizona,10,23
8/30/1997,NC State,32,Syracuse,31,1
8/30/1997,ULM,28,Nicholls St,0,28
8/30/1997,Oklahoma St,21,Iowa St,14,7
8/30/1997,Pittsburgh,45,ULL,13,32
8/30/1997,Tennessee,52,Texas Tech,17,35
8/30/1997,Utah St,21,Utah,14,7
8/30/1997,Vanderbilt,29,North Texas,12,17
8/30/1997,Virginia Tech,59,Rutgers,19,40
8/30/1997,Washington St,37,UCLA,34,3
8/30/1997,West Virginia,42,Marshall,31,11
9/4/1997,Auburn,28,Virginia,17,11
9/4/1997,Oregon,16,Arizona,9,7
9/5/1997,San Diego St,45,Navy,31,14
9/6/1997,Air Force,41,Rice,12,29
9/6/1997,Arkansas,28,ULM,16,12
9/6/1997,Ball St,24,James Madison,6,18
9/6/1997,Baylor,37,Fresno St,35,2
9/6/1997,Bowling Green,28,Miami OH,21,7
9/6/1997,California,35,Houston,3,32
9/6/1997,Clemson,23,Appalachian St,12,11
9/6/1997,Colorado,31,Colorado St,21,10
9/6/1997,Florida,82,C Michigan,6,76
9/6/1997,Florida St,14,USC,7,7
9/6/1997,Hawaii,34,CS Northridge,21,13
9/6/1997,Idaho,46,Portland St,0,46
9/6/1997,Iowa,66,Northern Iowa,0,66
9/6/1997,Kansas,17,TCU,10,7
9/6/1997,Kansas St,47,N Illinois,7,40
9/6/1997,LSU,55,UTEP,3,52
9/6/1997,Marshall,35,Army,25,10
9/6/1997,Memphis,28,UAB,7,21
9/6/1997,Michigan St,42,W Michigan,10,32
9/6/1997,Mississippi,23,SMU,15,8
9/6/1997,Mississippi St,35,Kentucky,27,8
9/6/1997,Missouri,44,E Michigan,24,20
9/6/1997,Nevada,31,UNLV,14,17
9/6/1997,New Mexico,61,New Mexico St,24,37
9/6/1997,North Carolina,23,Indiana,6,17
9/6/1997,NC State,45,Duke,14,31
9/6/1997,Notre Dame,17,Georgia Tech,13,4
9/6/1997,Ohio,21,Maryland,14,7
9/6/1997,Oklahoma,36,Syracuse,34,2
9/6/1997,Oklahoma St,31,ULL,7,24
9/6/1997,Oregon St,33,North Texas,7,26
9/6/1997,Penn St,34,Pittsburgh,17,17
9/6/1997,South Carolina,33,UCF,31,2
9/6/1997,Southern Miss,24,Illinois,7,17
9/6/1997,Stanford,28,San Jose St,12,16
9/6/1997,Temple,28,Boston College,21,7
9/6/1997,Tennessee,30,UCLA,24,6
9/6/1997,Texas,48,Rutgers,14,34
9/6/1997,Texas A&M,59,Sam Houston St,6,53
9/6/1997,Toledo,36,Purdue,22,14
9/6/1997,Tulane,31,Cincinnati,17,14
9/6/1997,Utah,27,Louisville,21,6
9/6/1997,Utah St,41,Idaho St,7,34
9/6/1997,Wake Forest,27,Northwestern,20,7
9/6/1997,Washington,42,BYU,20,22
9/6/1997,West Virginia,24,East Carolina,17,7
9/6/1997,Wisconsin,28,Boise St,24,4
9/6/1997,Wyoming,56,Iowa St,10,46
9/6/1997,Youngstown St,44,Kent,23,21
9/11/1997,Alabama,20,Vanderbilt,0,20
9/13/1997,Air Force,25,UNLV,24,1
9/13/1997,Arizona,24,UAB,10,14
9/13/1997,Arizona St,23,Miami FL,12,11
9/13/1997,Arkansas St,36,Cent Arkansas,35,1
9/13/1997,Army,41,Lafayette,14,27
9/13/1997,Auburn,19,Mississippi,9,10
9/13/1997,Boston College,31,West Virginia,24,7
9/13/1997,C Michigan,44,Boise St,26,18
9/13/1997,Clemson,19,NC State,17,2
9/13/1997,Colorado St,35,Utah St,24,11
9/13/1997,East Carolina,25,Wake Forest,24,1
9/13/1997,Florida St,50,Maryland,7,43
9/13/1997,Georgia,31,South Carolina,15,16
9/13/1997,Idaho,43,Idaho St,0,43
9/13/1997,Indiana,33,Ball St,6,27
9/13/1997,Iowa,54,Tulsa,16,38
9/13/1997,Kansas,15,Missouri,7,8
9/13/1997,Kansas St,23,Ohio,20,3
9/13/1997,LSU,24,Mississippi St,9,15
9/13/1997,Louisiana Tech,17,ULM,16,1
9/13/1997,Louisville,26,Illinois,14,12
9/13/1997,Marshall,42,Kent,17,25
9/13/1997,Miami OH,49,Akron,20,29
9/13/1997,Michigan,27,Colorado,3,24
9/13/1997,Michigan St,51,Memphis,21,30
9/13/1997,Minnesota,53,Iowa St,29,24
9/13/1997,Navy,36,Rutgers,7,29
9/13/1997,Nebraska,38,UCF,24,14
9/13/1997,New Mexico,38,UTEP,20,18
9/13/1997,New Mexico St,28,CS Northridge,18,10
9/13/1997,North Carolina,28,Stanford,17,11
9/13/1997,North Texas,41,Indiana St,6,35
9/13/1997,Northwestern,24,Duke,20,4
9/13/1997,Ohio St,44,Bowling Green,13,31
9/13/1997,Oklahoma St,35,Fresno St,0,35
9/13/1997,Oregon,24,Nevada,20,4
9/13/1997,Penn St,52,Temple,10,42
9/13/1997,Pittsburgh,35,Houston,24,11
9/13/1997,Purdue,28,Notre Dame,17,11
9/13/1997,Rice,30,Tulane,24,6
9/13/1997,SMU,31,Arkansas,9,22
9/13/1997,Texas Tech,59,ULL,14,45
9/13/1997,Toledo,38,E Michigan,35,3
9/13/1997,UCLA,66,Texas,3,63
9/13/1997,Utah,32,TCU,18,14
9/13/1997,Virginia,26,Richmond,7,19
9/13/1997,Virginia Tech,31,Syracuse,3,28
9/13/1997,Washington,36,San Diego St,3,33
9/13/1997,Washington St,28,USC,21,7
9/13/1997,W Michigan,21,N Illinois,13,8
9/13/1997,Wisconsin,56,San Jose St,10,46
9/13/1997,Wyoming,35,Hawaii,6,29
9/18/1997,Pittsburgh,21,Miami FL,17,4
9/20/1997,Air Force,24,Colorado St,0,24
9/20/1997,UAB,34,Jacksonville St,16,18
9/20/1997,Arkansas,17,Alabama,16,1
9/20/1997,Auburn,31,LSU,28,3
9/20/1997,Boise St,24,Weber St,7,17
9/20/1997,Boston College,35,Rutgers,21,14
9/20/1997,Bowling Green,31,Akron,28,3
9/20/1997,BYU,13,Arizona St,10,3
9/20/1997,California,40,Oklahoma,36,4
9/20/1997,UCF,41,Idaho,10,31
9/20/1997,Cincinnati,34,Kansas,7,27
9/20/1997,Duke,20,Army,17,3
9/20/1997,Florida,33,Tennessee,20,13
9/20/1997,Florida St,35,Clemson,28,7
9/20/1997,Georgia,42,ULM,3,39
9/20/1997,Georgia Tech,28,Wake Forest,26,2
9/20/1997,Iowa,63,Iowa St,20,43
9/20/1997,Kent,41,E Michigan,38,3
9/20/1997,Kentucky,49,Indiana,7,42
9/20/1997,Louisiana Tech,56,C Michigan,28,28
9/20/1997,Marshall,48,W Illinois,7,41
9/20/1997,Michigan,38,Baylor,3,35
9/20/1997,Michigan St,23,Notre Dame,7,16
9/20/1997,Minnesota,20,Memphis,17,3
9/20/1997,Missouri,42,Tulsa,21,21
9/20/1997,Navy,46,SMU,16,30
9/20/1997,Nebraska,27,Washington,14,13
9/20/1997,UNLV,25,Hawaii,15,10
9/20/1997,New Mexico,25,Utah St,22,3
9/20/1997,North Carolina,40,Maryland,14,26
9/20/1997,NC State,41,N Illinois,14,27
9/20/1997,North Texas,30,Texas Tech,27,3
9/20/1997,Ohio,50,Buffalo,0,50
9/20/1997,Ohio St,28,Arizona,20,8
9/20/1997,Oregon,43,Fresno St,40,3
9/20/1997,Penn St,57,Louisville,21,36
9/20/1997,Purdue,28,Ball St,14,14
9/20/1997,Rice,40,Northwestern,34,6
9/20/1997,South Carolina,26,East Carolina,0,26
9/20/1997,Southern Miss,35,Nevada,19,16
9/20/1997,Southern Utah,34,Arkansas St,24,10
9/20/1997,Stanford,27,Oregon St,24,3
9/20/1997,Syracuse,30,Tulane,19,11
9/20/1997,Texas A&M,66,ULL,0,66
9/20/1997,Toledo,23,W Michigan,13,10
9/20/1997,Utah,56,UTEP,3,53
9/20/1997,Vanderbilt,40,TCU,16,24
9/20/1997,Virginia Tech,23,Temple,13,10
9/20/1997,Washington St,35,Illinois,22,13
9/20/1997,Wisconsin,36,San Diego St,10,26
9/20/1997,Wyoming,30,San Jose St,10,20
9/25/1997,Wake Forest,19,NC State,18,1
9/27/1997,Air Force,24,San Diego St,18,6
9/27/1997,Alabama,27,Southern Miss,13,14
9/27/1997,UAB,42,ULL,7,35
9/27/1997,Arizona St,13,Oregon St,10,3
9/27/1997,Arkansas,17,Louisiana Tech,13,4
9/27/1997,Auburn,41,UCF,14,27
9/27/1997,BYU,19,SMU,16,3
9/27/1997,Cincinnati,24,Boston College,6,18
9/27/1997,Colorado,20,Wyoming,19,1
9/27/1997,Duke,26,Navy,17,9
9/27/1997,E Michigan,31,C Michigan,24,7
9/27/1997,Florida,55,Kentucky,28,27
9/27/1997,Georgia Tech,23,Clemson,20,3
9/27/1997,Houston,45,Minnesota,43,2
9/27/1997,Iowa,38,Illinois,10,28
9/27/1997,Kansas St,58,Bowling Green,0,58
9/27/1997,LSU,56,Akron,0,56
9/27/1997,Marshall,42,Ball St,16,26
9/27/1997,Maryland,24,Temple,21,3
9/27/1997,Miami OH,38,Army,14,24
9/27/1997,Michigan,21,Notre Dame,14,7
9/27/1997,Mississippi,15,Vanderbilt,3,12
9/27/1997,Mississippi St,37,South Carolina,17,20
9/27/1997,UNLV,41,Illinois St,6,35
9/27/1997,North Carolina,48,Virginia,20,28
9/27/1997,Ohio,31,W Michigan,7,24
9/27/1997,Ohio St,31,Missouri,10,21
9/27/1997,Oklahoma,35,Louisville,14,21
9/27/1997,Oklahoma St,38,ULM,7,31
9/27/1997,Purdue,21,Northwestern,9,12
9/27/1997,USC,27,California,17,10
9/27/1997,Stanford,58,Oregon,49,9
9/27/1997,Texas,38,Rice,31,7
9/27/1997,Texas A&M,36,North Texas,10,26
9/27/1997,UTEP,24,New Mexico St,16,8
9/27/1997,Toledo,31,Nevada,13,18
9/27/1997,UCLA,40,Arizona,27,13
9/27/1997,Virginia Tech,50,Arkansas St,0,50
9/27/1997,Washington St,58,Boise St,0,58
9/27/1997,West Virginia,28,Miami FL,17,11
9/27/1997,Wisconsin,27,Indiana,26,1
10/2/1997,Fresno St,27,Utah,13,14
10/3/1997,BYU,42,Utah St,35,7
10/4/1997,Air Force,17,Citadel,3,14
10/4/1997,Akron,53,C Michigan,14,39
10/4/1997,UAB,20,WKU,16,4
10/4/1997,Arizona,31,San Diego St,28,3
10/4/1997,Auburn,23,South Carolina,6,17
10/4/1997,Bowling Green,35,N Illinois,10,25
10/4/1997,Caloly SLO,38,New Mexico St,35,3
10/4/1997,UCF,59,Kent,43,16
10/4/1997,Cincinnati,20,Memphis,17,3
10/4/1997,Clemson,39,UTEP,7,32
10/4/1997,Colorado St,63,Hawaii,0,63
10/4/1997,Florida,56,Arkansas,7,49
10/4/1997,Florida St,47,Miami FL,0,47
10/4/1997,Georgia,47,Mississippi St,0,47
10/4/1997,Georgia Tech,42,Boston College,14,28
10/4/1997,Idaho,30,North Texas,17,13
10/4/1997,Kansas,20,Oklahoma,17,3
10/4/1997,Kentucky,40,Alabama,34,6
10/4/1997,LSU,7,Vanderbilt,6,1
10/4/1997,Louisiana Tech,41,California,34,7
10/4/1997,Maryland,16,Duke,10,6
10/4/1997,Miami OH,24,Virginia Tech,17,7
10/4/1997,Michigan,37,Indiana,0,37
10/4/1997,Michigan St,31,Minnesota,10,21
10/4/1997,Missouri,45,Iowa St,21,24
10/4/1997,Nebraska,56,Kansas St,26,30
10/4/1997,New Mexico,22,SMU,15,7
10/4/1997,North Carolina,31,TCU,10,21
10/4/1997,ULM,17,Northwestern LA,7,10
10/4/1997,Ohio,47,E Michigan,7,40
10/4/1997,Ohio St,23,Iowa,7,16
10/4/1997,Oklahoma St,42,Texas,16,26
10/4/1997,Oregon St,26,San Jose St,12,14
10/4/1997,Penn St,41,Illinois,6,35
10/4/1997,Rice,42,Tulsa,24,18
10/4/1997,USC,35,UNLV,21,14
10/4/1997,Southern Miss,42,Louisville,24,18
10/4/1997,ULL,41,Arkansas St,38,3
10/4/1997,Stanford,33,Notre Dame,15,18
10/4/1997,Syracuse,56,East Carolina,0,56
10/4/1997,Temple,17,Pittsburgh,13,4
10/4/1997,Tennessee,31,Mississippi,17,14
10/4/1997,Texas A&M,16,Colorado,10,6
10/4/1997,Texas Tech,35,Baylor,14,21
10/4/1997,Tulane,41,Army,0,41
10/4/1997,UCLA,66,Houston,10,56
10/4/1997,Virginia,21,Wake Forest,13,8
10/4/1997,Washington,26,Arizona St,14,12
10/4/1997,Washington St,24,Oregon,13,11
10/4/1997,West Virginia,48,Rutgers,0,48
10/4/1997,W Michigan,21,Ball St,13,8
10/4/1997,Wisconsin,26,Northwestern,25,1
10/4/1997,Wyoming,28,Montana,13,15
10/9/1997,Syracuse,50,Rutgers,3,47
10/11/1997,Air Force,10,Navy,7,3
10/11/1997,Arizona,28,Stanford,22,6
10/11/1997,Arizona St,35,USC,7,28
10/11/1997,Auburn,49,Louisiana Tech,13,36
10/11/1997,Boise St,52,New Mexico St,10,42
10/11/1997,UCF,52,Samford,7,45
10/11/1997,Cincinnati,33,UAB,29,4
10/11/1997,Colorado St,55,San Jose St,20,35
10/11/1997,E Michigan,38,Ball St,32,6
10/11/1997,Florida St,51,Duke,27,24
10/11/1997,Georgia Tech,27,NC State,17,10
10/11/1997,Hawaii,28,Fresno St,16,12
10/11/1997,Idaho,44,UC Davis,14,30
10/11/1997,Kansas St,41,Missouri,11,30
10/11/1997,LSU,28,Florida,21,7
10/11/1997,Marshall,52,Akron,17,35
10/11/1997,Memphis,38,Arkansas St,9,29
10/11/1997,Miami OH,62,Kent,26,36
10/11/1997,Michigan,23,Northwestern,6,17
10/11/1997,Michigan St,38,Indiana,6,32
10/11/1997,Mississippi St,24,ULM,10,14
10/11/1997,Nebraska,49,Baylor,21,28
10/11/1997,UNLV,21,TCU,19,2
10/11/1997,New Mexico,36,San Diego St,21,15
10/11/1997,North Alabama,48,ULL,42,6
10/11/1997,North Carolina,30,Wake Forest,12,18
10/11/1997,Notre Dame,45,Pittsburgh,21,24
10/11/1997,Oklahoma St,33,Colorado,29,4
10/11/1997,Oregon St,24,Utah St,16,8
10/11/1997,Penn St,31,Ohio St,27,4
10/11/1997,Purdue,59,Minnesota,43,16
10/11/1997,Rice,27,BYU,14,13
10/11/1997,South Carolina,38,Kentucky,24,14
10/11/1997,SMU,20,Utah,19,1
10/11/1997,Southern Miss,23,East Carolina,13,10
10/11/1997,Tennessee,38,Georgia,13,25
10/11/1997,Texas,27,Oklahoma,24,3
10/11/1997,Texas A&M,56,Iowa St,17,39
10/11/1997,Texas Tech,17,Kansas,7,10
10/11/1997,UTEP,33,Tulsa,18,15
10/11/1997,Toledo,41,C Michigan,10,31
10/11/1997,Tulane,64,Louisville,33,31
10/11/1997,UCLA,39,Oregon,31,8
10/11/1997,Vanderbilt,17,N Illinois,7,10
10/11/1997,Virginia,21,Clemson,7,14
10/11/1997,Virginia Tech,17,Boston College,7,10
10/11/1997,Washington,30,California,3,27
10/11/1997,West Virginia,31,Maryland,14,17
10/11/1997,W Michigan,34,Bowling Green,21,13
10/11/1997,Wisconsin,31,Illinois,7,24
10/11/1997,Wyoming,34,Nevada,30,4
10/18/1997,Arizona St,31,Stanford,14,17
10/18/1997,Army,37,Rutgers,35,2
10/18/1997,Ball St,37,C Michigan,34,3
10/18/1997,Boise St,17,North Texas,14,3
10/18/1997,BYU,17,Hawaii,3,14
10/18/1997,Colorado,42,Kansas,6,36
10/18/1997,Colorado St,14,Wyoming,7,7
10/18/1997,E Michigan,45,Akron,0,45
10/18/1997,Florida,24,Auburn,10,14
10/18/1997,Florida St,38,Georgia Tech,0,38
10/18/1997,Fresno St,20,Air Force,17,3
10/18/1997,Georgia,34,Vanderbilt,13,21
10/18/1997,Houston,41,Cincinnati,38,3
10/18/1997,Kansas St,36,Texas A&M,17,19
10/18/1997,Kentucky,49,ULM,14,35
10/18/1997,Louisiana Tech,42,Arkansas St,14,28
10/18/1997,Miami FL,45,Boston College,44,1
10/18/1997,Miami OH,45,Marshall,21,24
10/18/1997,Michigan,28,Iowa,24,4
10/18/1997,Mississippi,36,LSU,21,15
10/18/1997,Missouri,37,Texas,29,8
10/18/1997,Navy,42,VMI,7,35
10/18/1997,Nebraska,29,Texas Tech,0,29
10/18/1997,Nevada,42,Idaho,23,19
10/18/1997,North Carolina,20,NC State,7,13
10/18/1997,Northwestern,19,Michigan St,17,2
10/18/1997,Ohio,24,Bowling Green,0,24
10/18/1997,Ohio St,31,Indiana,0,31
10/18/1997,Oklahoma,24,Baylor,23,1
10/18/1997,Oregon,31,Utah,13,18
10/18/1997,Penn St,16,Minnesota,15,1
10/18/1997,Purdue,45,Wisconsin,20,25
10/18/1997,Rice,35,New Mexico,23,12
10/18/1997,San Diego St,20,UNLV,17,3
10/18/1997,San Jose St,10,UTEP,7,3
10/18/1997,South Carolina,39,Arkansas,13,26
10/18/1997,USC,20,Notre Dame,17,3
10/18/1997,Syracuse,60,Temple,7,53
10/18/1997,Tennessee,38,Alabama,21,17
10/18/1997,Toledo,41,N Illinois,14,27
10/18/1997,Tulane,33,East Carolina,16,17
10/18/1997,Tulsa,33,TCU,22,11
10/18/1997,UCLA,34,Oregon St,10,24
10/18/1997,Utah St,38,New Mexico St,7,31
10/18/1997,Virginia,13,Duke,10,3
10/18/1997,Wake Forest,35,Maryland,17,18
10/18/1997,Washington,58,Arizona,28,30
10/18/1997,Washington St,63,California,37,26
10/18/1997,W Michigan,50,Kent,27,23
10/25/1997,Alabama,29,Mississippi,20,9
10/25/1997,Army,35,Colgate,27,8
10/25/1997,Auburn,26,Arkansas,21,5
10/25/1997,Ball St,21,N Illinois,14,7
10/25/1997,BYU,31,TCU,10,21
10/25/1997,Cincinnati,34,Miami OH,31,3
10/25/1997,Clemson,20,Maryland,9,11
10/25/1997,Colorado,47,Texas,30,17
10/25/1997,East Carolina,32,Memphis,10,22
10/25/1997,Florida St,47,Virginia,21,26
10/25/1997,Fresno St,46,UNLV,28,18
10/25/1997,Georgia,23,Kentucky,13,10
10/25/1997,Houston,36,Louisville,22,14
10/25/1997,Iowa,62,Indiana,0,62
10/25/1997,Iowa St,24,Baylor,17,7
10/25/1997,Kansas St,26,Oklahoma,7,19
10/25/1997,Kent,60,C Michigan,37,23
10/25/1997,Louisiana Tech,31,Boise St,27,4
10/25/1997,Marshall,48,E Michigan,25,23
10/25/1997,Miami FL,47,Temple,15,32
10/25/1997,Michigan,23,Michigan St,7,16
10/25/1997,Mississippi St,35,UCF,28,7
10/25/1997,Missouri,51,Oklahoma St,50,1
10/25/1997,Nebraska,35,Kansas,0,35
10/25/1997,Nevada,65,North Texas,10,55
10/25/1997,New Mexico St,34,Arkansas St,20,14
10/25/1997,ULM,28,ULL,21,7
10/25/1997,Notre Dame,52,Boston College,20,32
10/25/1997,Ohio,21,Akron,17,4
10/25/1997,Ohio St,49,Northwestern,6,43
10/25/1997,Pittsburgh,55,Rutgers,48,7
10/25/1997,Purdue,48,Illinois,3,45
10/25/1997,San Diego St,10,Hawaii,3,7
10/25/1997,San Jose St,25,Air Force,22,3
10/25/1997,South Carolina,35,Vanderbilt,3,32
10/25/1997,USC,24,Oregon,22,2
10/25/1997,SMU,22,Wyoming,17,5
10/25/1997,Southern Miss,34,Tulane,13,21
10/25/1997,Texas Tech,16,Texas A&M,13,3
10/25/1997,Toledo,35,Bowling Green,20,15
10/25/1997,UCLA,35,California,17,18
10/25/1997,Utah,15,New Mexico,10,5
10/25/1997,Utah St,63,Idaho,17,46
10/25/1997,Wake Forest,38,Duke,24,14
10/25/1997,Washington,45,Oregon St,17,28
10/25/1997,Washington St,35,Arizona,34,1
10/25/1997,West Virginia,30,Virginia Tech,17,13
10/25/1997,Wisconsin,22,Minnesota,21,1
10/26/1997,Colorado St,44,Tulsa,8,36
10/30/1997,North Carolina,16,Georgia Tech,13,3
11/1/1997,Air Force,34,Hawaii,27,7
11/1/1997,Arizona St,44,Washington St,31,13
11/1/1997,Ball St,31,Akron,14,17
11/1/1997,Baylor,23,Texas,21,2
11/1/1997,Boston College,22,Pittsburgh,21,1
11/1/1997,California,33,Oregon St,14,19
11/1/1997,Clemson,33,Wake Forest,16,17
11/1/1997,Colorado St,45,UNLV,19,26
11/1/1997,East Carolina,45,Louisville,31,14
11/1/1997,E Washington,24,Idaho,21,3
11/1/1997,Florida St,48,NC State,35,13
11/1/1997,Fresno St,53,San Jose St,12,41
11/1/1997,Georgia,37,Florida,17,20
11/1/1997,Indiana,23,Illinois,6,17
11/1/1997,Iowa,35,Purdue,17,18
11/1/1997,Kansas,34,Iowa St,24,10
11/1/1997,Kansas St,13,Texas Tech,2,11
11/1/1997,Kent,29,Bowling Green,20,9
11/1/1997,LSU,63,Kentucky,28,35
11/1/1997,Louisiana Tech,26,Alabama,20,6
11/1/1997,Marshall,45,C Michigan,17,28
11/1/1997,Memphis,24,Houston,3,21
11/1/1997,Miami FL,42,Arkansas St,10,32
11/1/1997,Michigan,24,Minnesota,3,21
11/1/1997,Mississippi St,20,Auburn,0,20
11/1/1997,Missouri,41,Colorado,31,10
11/1/1997,Nebraska,69,Oklahoma,7,62
11/1/1997,Nevada,45,New Mexico St,24,21
11/1/1997,New Mexico,40,TCU,10,30
11/1/1997,ULM,45,UCF,41,4
11/1/1997,Notre Dame,21,Navy,17,4
11/1/1997,Ohio,35,N Illinois,30,5
11/1/1997,Ohio St,37,Michigan St,13,24
11/1/1997,Penn St,30,Northwestern,27,3
11/1/1997,SMU,24,Rice,6,18
11/1/1997,Southern Miss,24,Cincinnati,17,7
11/1/1997,Syracuse,40,West Virginia,10,30
11/1/1997,Temple,49,Rutgers,7,42
11/1/1997,Tennessee,22,South Carolina,7,15
11/1/1997,Texas A&M,28,Oklahoma St,25,3
11/1/1997,UTEP,14,BYU,3,11
11/1/1997,Toledo,35,Miami OH,28,7
11/1/1997,Tulane,56,ULL,0,56
11/1/1997,Tulsa,21,Utah,13,8
11/1/1997,UCLA,27,Stanford,7,20
11/1/1997,Utah St,24,Boise St,20,4
11/1/1997,Virginia,45,Maryland,0,45
11/1/1997,Virginia Tech,37,UAB,0,37
11/1/1997,Washington,27,USC,0,27
11/1/1997,W Michigan,41,E Michigan,38,3
11/1/1997,Wyoming,41,San Diego St,17,24
11/6/1997,Mississippi,19,Arkansas,9,10
11/8/1997,Air Force,24,Army,0,24
11/8/1997,Akron,45,Kent,35,10
11/8/1997,Arizona,27,Oregon St,7,20
11/8/1997,Arizona St,28,California,21,7
11/8/1997,Arkansas St,35,Missouri St,27,8
11/8/1997,Ball St,35,Toledo,3,32
11/8/1997,BYU,49,Tulsa,39,10
11/8/1997,Cincinnati,28,Louisville,9,19
11/8/1997,Clemson,29,Duke,20,9
11/8/1997,Colorado,43,Iowa St,38,5
11/8/1997,Colorado St,41,Fresno St,3,38
11/8/1997,East Carolina,28,Houston,27,1
11/8/1997,E Michigan,38,N Illinois,10,28
11/8/1997,Florida,20,Vanderbilt,7,13
11/8/1997,Florida St,20,North Carolina,3,17
11/8/1997,Kansas St,48,Kansas,16,32
11/8/1997,LSU,27,Alabama,0,27
11/8/1997,Louisiana Tech,32,UAB,29,3
11/8/1997,Marshall,28,Bowling Green,0,28
11/8/1997,Miami OH,45,Ohio,21,24
11/8/1997,Michigan,34,Penn St,8,26
11/8/1997,Navy,49,Temple,17,32
11/8/1997,Nebraska,45,Missouri,38,7
11/8/1997,Nevada,56,Boise St,42,14
11/8/1997,NC State,45,Maryland,28,17
11/8/1997,North Texas,26,New Mexico St,15,11
11/8/1997,Northwestern,34,Illinois,21,13
11/8/1997,Ohio St,31,Minnesota,3,28
11/8/1997,Oklahoma St,30,Oklahoma,7,23
11/8/1997,Oregon,31,Washington,28,3
11/8/1997,Purdue,22,Michigan St,21,1
11/8/1997,Rice,38,TCU,19,19
11/8/1997,San Diego St,48,San Jose St,21,27
11/8/1997,USC,45,Stanford,21,24
11/8/1997,SMU,28,UTEP,14,14
11/8/1997,Syracuse,20,Boston College,13,7
11/8/1997,Tennessee,44,Southern Miss,20,24
11/8/1997,Texas A&M,38,Baylor,10,28
11/8/1997,Texas Tech,24,Texas,10,14
11/8/1997,Tulane,26,Memphis,14,12
11/8/1997,Virginia,35,Georgia Tech,31,4
11/8/1997,Virginia Tech,27,Miami FL,25,2
11/8/1997,Wake Forest,28,Rutgers,14,14
11/8/1997,Washington St,77,ULL,7,70
11/8/1997,W Michigan,38,C Michigan,24,14
11/8/1997,Wisconsin,13,Iowa,10,3
11/8/1997,Wyoming,35,UNLV,23,12
11/13/1997,East Carolina,14,Cincinnati,7,7
11/14/1997,Idaho,35,New Mexico St,18,17
11/15/1997,Air Force,14,Wyoming,3,11
11/15/1997,UAB,38,Tennessee Tech,14,24
11/15/1997,Arizona,41,California,38,3
11/15/1997,Arizona St,52,Oregon,31,21
11/15/1997,Army,25,North Texas,14,11
11/15/1997,Auburn,45,Georgia,34,11
11/15/1997,UCF,27,E Michigan,10,17
11/15/1997,Florida,48,South Carolina,21,27
11/15/1997,Florida St,58,Wake Forest,7,51
11/15/1997,Georgia Tech,41,Duke,38,3
11/15/1997,Kansas St,37,Colorado,20,17
11/15/1997,Kentucky,21,Vanderbilt,10,11
11/15/1997,Louisiana Tech,63,ULL,24,39
11/15/1997,Marshall,27,Ohio,0,27
11/15/1997,Memphis,21,Louisville,20,1
11/15/1997,Miami FL,51,Rutgers,23,28
11/15/1997,Miami OH,42,N Illinois,0,42
11/15/1997,Michigan,26,Wisconsin,16,10
11/15/1997,Minnesota,24,Indiana,12,12
11/15/1997,Mississippi,41,Tulane,24,17
11/15/1997,Mississippi St,32,Alabama,20,12
11/15/1997,Missouri,42,Baylor,24,18
11/15/1997,Navy,52,Colgate,24,28
11/15/1997,Nebraska,77,Iowa St,14,63
11/15/1997,New Mexico,38,BYU,28,10
11/15/1997,North Carolina,17,Clemson,10,7
11/15/1997,NC State,31,Virginia,24,7
11/15/1997,Northwestern,15,Iowa,14,1
11/15/1997,Notre Dame,24,LSU,6,18
11/15/1997,Ohio St,41,Illinois,6,35
11/15/1997,Penn St,42,Purdue,17,25
11/15/1997,San Diego St,20,Fresno St,19,1
11/15/1997,San Jose St,38,Hawaii,14,24
11/15/1997,USC,23,Oregon St,0,23
11/15/1997,SMU,42,Tulsa,41,1
11/15/1997,Southern Miss,33,Houston,0,33
11/15/1997,Syracuse,32,Pittsburgh,27,5
11/15/1997,Tennessee,30,Arkansas,22,8
11/15/1997,Texas,45,Kansas,31,14
11/15/1997,Texas A&M,51,Oklahoma,7,44
11/15/1997,Texas Tech,27,Oklahoma St,3,24
11/15/1997,UTEP,24,TCU,17,7
11/15/1997,Toledo,42,Akron,10,32
11/15/1997,UCLA,52,Washington,28,24
11/15/1997,Utah,31,Rice,14,17
11/15/1997,Utah St,38,Nevada,19,19
11/15/1997,Washington St,38,Stanford,28,10
11/15/1997,West Virginia,41,Temple,21,20
11/15/1997,W Michigan,32,ULM,19,13
11/20/1997,TCU,21,SMU,18,3
11/22/1997,UAB,13,Arkansas St,7,6
11/22/1997,Arkansas,17,Mississippi St,7,10
11/22/1997,Auburn,18,Alabama,17,1
11/22/1997,Boise St,30,Idaho,23,7
11/22/1997,Boston College,24,Army,20,4
11/22/1997,UCF,34,Toledo,17,17
11/22/1997,Clemson,47,South Carolina,21,26
11/22/1997,Colorado St,38,San Diego St,17,21
11/22/1997,Florida,32,Florida St,29,3
11/22/1997,Fresno St,24,Wyoming,7,17
11/22/1997,Georgia,21,Mississippi,14,7
11/22/1997,Georgia Tech,37,Maryland,18,19
11/22/1997,Iowa,31,Minnesota,0,31
11/22/1997,Kansas St,28,Iowa St,3,25
11/22/1997,Michigan,20,Ohio St,14,6
11/22/1997,Michigan St,27,Illinois,17,10
11/22/1997,Navy,62,Kent,29,33
11/22/1997,New Mexico,51,Tulsa,13,38
11/22/1997,North Carolina,50,Duke,14,36
11/22/1997,NC State,37,East Carolina,24,13
11/22/1997,North Texas,51,Utah St,48,3
11/22/1997,ULM,23,Hawaii,20,3
11/22/1997,Notre Dame,21,West Virginia,14,7
11/22/1997,Oklahoma,32,Texas Tech,21,11
11/22/1997,Oklahoma St,24,Baylor,14,10
11/22/1997,Oregon,48,Oregon St,30,18
11/22/1997,Penn St,35,Wisconsin,10,25
11/22/1997,Pittsburgh,30,Virginia Tech,23,7
11/22/1997,Purdue,56,Indiana,7,49
11/22/1997,Rice,31,UTEP,13,18
11/22/1997,San Jose St,55,UNLV,48,7
11/22/1997,Southern Miss,42,Memphis,18,24
11/22/1997,Stanford,21,California,20,1
11/22/1997,Tennessee,59,Kentucky,31,28
11/22/1997,Tulane,44,Houston,10,34
11/22/1997,UCLA,31,USC,24,7
11/22/1997,Utah,20,BYU,14,6
11/22/1997,Washington St,41,Washington,35,6
11/28/1997,Arizona,28,Arizona St,16,12
11/28/1997,LSU,31,Arkansas,21,10
11/28/1997,Nebraska,27,Colorado,24,3
11/28/1997,Pittsburgh,41,West Virginia,38,3
11/28/1997,Texas A&M,27,Texas,16,11
11/29/1997,Georgia,27,Georgia Tech,24,3
11/29/1997,Michigan St,49,Penn St,14,35
11/29/1997,Mississippi,15,Mississippi St,14,1
11/29/1997,Notre Dame,23,Hawaii,22,1
11/29/1997,Syracuse,33,Miami FL,13,20
11/29/1997,Tennessee,17,Vanderbilt,10,7
11/29/1997,Virginia,34,Virginia Tech,20,14
12/5/1997,Marshall,34,Toledo,14,20
12/6/1997,Colorado St,41,New Mexico,13,28
12/6/1997,Navy,39,Army,7,32
12/6/1997,Nebraska,54,Texas A&M,15,39
12/6/1997,Tennessee,30,Auburn,29,1
12/20/1997,Oregon,41,Air Force,13,28
12/25/1997,Washington,51,Michigan St,23,28
12/26/1997,Mississippi,34,Marshall,31,3
12/27/1997,Arizona,20,New Mexico,14,6
12/28/1997,LSU,27,Notre Dame,9,18
12/29/1997,Cincinnati,35,Utah St,19,16
12/29/1997,Colorado St,35,Missouri,24,11
12/29/1997,Georgia Tech,35,West Virginia,30,5
12/30/1997,Purdue,33,Oklahoma St,20,13
12/31/1997,Arizona St,17,Iowa,7,10
12/31/1997,Kansas St,35,Syracuse,18,17
12/31/1997,Southern Miss,41,Pittsburgh,7,34
1/1/1998,Florida,21,Penn St,6,15
1/1/1998,Florida St,31,Ohio St,14,17
1/1/1998,Georgia,33,Wisconsin,6,27
1/1/1998,Michigan,21,Washington St,16,5
1/1/1998,North Carolina,42,Virginia Tech,3,39
1/1/1998,UCLA,29,Texas A&M,23,6
1/2/1998,Auburn,21,Clemson,17,4
1/2/1998,Nebraska,42,Tennessee,17,25
