9/3/2015,Georgia Tech,69,Alcorn St,6,63
9/3/2015,Duke,37,Tulane,7,30
9/3/2015,Utah,24,Michigan,17,7
9/3/2015,San Jose St,43,New Hampshire,13,30
9/3/2015,Ohio,45,Idaho,28,17
9/3/2015,South Carolina,17,North Carolina,13,4
9/3/2015,TCU,23,Minnesota,17,6
9/3/2015,Ball St,48,VMI,36,12
9/3/2015,Connecticut,20,Villanova,15,5
9/3/2015,Wake Forest,41,Elon,3,38
9/3/2015,Nevada,31,UC Davis,17,14
9/3/2015,Arizona,42,UT San Antonio,32,10
9/3/2015,WKU,14,Vanderbilt,12,2
9/3/2015,Florida Intl,15,UCF,14,1
9/3/2015,Fresno St,34,Abilene Chr,13,21
9/3/2015,Utah St,12,Southern Utah,9,3
9/3/2015,Hawaii,28,Colorado,20,8
9/3/2015,Oklahoma St,24,C Michigan,13,11
9/4/2015,Charlotte,23,Georgia St,20,3
9/4/2015,Boise St,16,Washington,13,3
9/4/2015,Michigan St,37,W Michigan,24,13
9/4/2015,Baylor,56,SMU,21,35
9/4/2015,Fordham,37,Army,35,2
9/4/2015,Oregon St,26,Weber St,7,19
9/4/2015,Syracuse,47,Rhode Island,0,47
9/5/2015,NC State,49,Troy,21,28
9/5/2015,Clemson,49,Wofford,10,39
9/5/2015,Missouri,34,SE Missouri St,3,31
9/5/2015,Mississippi,76,TN Martin,3,73
9/5/2015,Rice,56,Wagner,16,40
9/5/2015,East Carolina,28,Towson,20,8
9/5/2015,Pittsburgh,45,Youngstown St,37,8
9/5/2015,Air Force,63,Morgan St,7,56
9/5/2015,Alabama,35,Wisconsin,17,18
9/5/2015,UCLA,34,Virginia,16,18
9/5/2015,Arkansas,48,UTEP,13,35
9/5/2015,Old Dominion,38,E Michigan,34,4
9/5/2015,Miami OH,26,Presbyterian,7,19
9/5/2015,Buffalo,51,Albany NY,14,37
9/5/2015,S Dakota St,41,Kansas,38,3
9/5/2015,North Dakota,24,Wyoming,13,11
9/5/2015,Kansas St,34,South Dakota,0,34
9/5/2015,Colorado St,65,Savannah St,13,52
9/5/2015,Portland St,24,Washington St,17,7
9/5/2015,Cincinnati,52,Alabama A&M,10,42
9/5/2015,Tulsa,47,FL Atlantic,44,3
9/5/2015,Auburn,31,Louisville,24,7
9/5/2015,Boston College,24,Maine,3,21
9/5/2015,South Florida,51,Florida A&M,3,48
9/5/2015,West Virginia,44,Ga Southern,0,44
9/5/2015,California,73,Grambling,14,59
9/5/2015,Appalachian St,49,Howard,0,49
9/5/2015,Iowa,31,Illinois St,14,17
9/5/2015,Miami FL,45,Bethune-Cookman,0,45
9/5/2015,South Alabama,33,Gardner Webb,23,10
9/5/2015,Texas A&M,38,Arizona St,17,21
9/5/2015,USC,55,Arkansas St,6,49
9/5/2015,Oklahoma,41,Akron,3,38
9/5/2015,Oregon,61,E Washington,42,19
9/5/2015,Tennessee,59,Bowling Green,30,29
9/5/2015,BYU,33,Nebraska,28,5
9/5/2015,Mississippi St,34,Southern Miss,16,18
9/5/2015,New Mexico,66,MS Valley St,0,66
9/5/2015,N Illinois,38,UNLV,30,8
9/5/2015,Florida,61,New Mexico St,13,48
9/5/2015,Georgia,51,ULM,14,37
9/5/2015,Iowa St,31,Northern Iowa,7,24
9/5/2015,Houston,52,Tennessee Tech,24,28
9/5/2015,Notre Dame,38,Texas,3,35
9/5/2015,Northwestern,16,Stanford,6,10
9/5/2015,Texas Tech,59,Sam Houston St,45,14
9/5/2015,Indiana,48,S Illinois,47,1
9/5/2015,Louisiana Tech,62,Southern Univ,15,47
9/5/2015,Florida St,59,Texas St,16,43
9/5/2015,Memphis,63,Missouri St,7,56
9/5/2015,Kentucky,40,ULL,33,7
9/5/2015,Rutgers,63,Norfolk St,13,50
9/5/2015,Temple,27,Penn St,10,17
9/5/2015,Maryland,50,Richmond,21,29
9/5/2015,Navy,48,Colgate,10,38
9/5/2015,MTSU,70,Jackson St,14,56
9/5/2015,San Diego St,37,San Diego,3,34
9/5/2015,Illinois,52,Kent,3,49
9/6/2015,Marshall,41,Purdue,31,10
9/7/2015,Ohio St,42,Virginia Tech,24,18
9/10/2015,WKU,41,Louisiana Tech,38,3
9/11/2015,Miami FL,44,FL Atlantic,20,24
9/11/2015,Utah,24,Utah St,14,10
9/12/2015,Notre Dame,34,Virginia,27,7
9/12/2015,SMU,31,North Texas,13,18
9/12/2015,ULM,47,Nicholls St,0,47
9/12/2015,North Carolina,53,NC A&T,14,39
9/12/2015,Missouri,27,Arkansas St,20,7
9/12/2015,N Illinois,57,Murray St,26,31
9/12/2015,Alabama,37,MTSU,10,27
9/12/2015,Minnesota,23,Colorado St,20,3
9/12/2015,Wisconsin,58,Miami OH,0,58
9/12/2015,Colorado,48,Massachusetts,14,34
9/12/2015,Texas,42,Rice,28,14
9/12/2015,Pittsburgh,24,Akron,7,17
9/12/2015,Texas St,63,Prairie View,24,39
9/12/2015,California,35,San Diego St,7,28
9/12/2015,Air Force,37,San Jose St,16,21
9/12/2015,Michigan St,31,Oregon,28,3
9/12/2015,Old Dominion,24,Norfolk St,10,14
9/12/2015,Michigan,35,Oregon St,7,28
9/12/2015,Oklahoma,31,Tennessee,24,7
9/12/2015,Temple,34,Cincinnati,26,8
9/12/2015,TCU,70,SF Austin,7,63
9/12/2015,Purdue,38,Indiana St,14,24
9/12/2015,Iowa,31,Iowa St,17,14
9/12/2015,LSU,21,Mississippi St,19,2
9/12/2015,Kansas St,30,UT San Antonio,3,27
9/12/2015,Memphis,55,Kansas,23,32
9/12/2015,Ohio,21,Marshall,10,11
9/12/2015,Kentucky,26,South Carolina,22,4
9/12/2015,Boston College,76,Howard,0,76
9/12/2015,USC,59,Idaho,9,50
9/12/2015,Ohio St,38,Hawaii,0,38
9/12/2015,Houston,34,Louisville,31,3
9/12/2015,Mississippi,73,Fresno St,21,52
9/12/2015,Georgia,31,Vanderbilt,14,17
9/12/2015,Arizona St,35,Cal Poly SLO,21,14
9/12/2015,Virginia Tech,42,Furman,3,39
9/12/2015,Northwestern,41,E Illinois,0,41
9/12/2015,NC State,35,E Kentucky,0,35
9/12/2015,E Michigan,48,Wyoming,29,19
9/12/2015,Florida,31,East Carolina,24,7
9/12/2015,Kent,45,Delaware St,13,32
9/12/2015,Bowling Green,48,Maryland,27,21
9/12/2015,Clemson,41,Appalachian St,10,31
9/12/2015,Arizona,44,Nevada,20,24
9/12/2015,Texas A&M,56,Ball St,23,33
9/12/2015,BYU,35,Boise St,24,11
9/12/2015,Connecticut,22,Army,17,5
9/12/2015,Southern Miss,52,Austin Peay,6,46
9/12/2015,C Michigan,31,Monmouth NJ,10,21
9/12/2015,Florida St,34,South Florida,14,20
9/12/2015,Washington,49,CS Sacramento,0,49
9/12/2015,Duke,55,NC Central,0,55
9/12/2015,Troy,44,Charleston So,16,28
9/12/2015,Charlotte,34,Presbyterian,10,24
9/12/2015,Oklahoma St,32,Cent Arkansas,8,24
9/12/2015,Indiana,36,Florida Intl,22,14
9/12/2015,Georgia St,34,New Mexico St,32,2
9/12/2015,Baylor,66,Lamar,31,35
9/12/2015,Nebraska,48,South Alabama,9,39
9/12/2015,Texas Tech,69,UTEP,20,49
9/12/2015,Toledo,16,Arkansas,12,4
9/12/2015,Georgia Tech,65,Tulane,10,55
9/12/2015,Tulsa,40,New Mexico,21,19
9/12/2015,UCLA,37,UNLV,3,34
9/12/2015,Syracuse,30,Wake Forest,17,13
9/12/2015,West Virginia,41,Liberty,17,24
9/12/2015,Auburn,27,Jacksonville St,20,7
9/12/2015,Penn St,27,Buffalo,14,13
9/12/2015,Stanford,31,UCF,7,24
9/12/2015,Ga Southern,43,W Michigan,17,26
9/12/2015,Illinois,44,W Illinois,0,44
9/12/2015,Washington St,37,Rutgers,34,3
9/12/2015,ULL,44,Northwestern LA,17,27
9/17/2015,Clemson,20,Louisville,17,3
9/18/2015,Florida St,14,Boston College,0,14
9/18/2015,Boise St,52,Idaho St,0,52
9/18/2015,Arizona St,34,New Mexico,10,24
9/19/2015,Texas A&M,44,Nevada,27,17
9/19/2015,NC State,38,Old Dominion,14,24
9/19/2015,Northwestern,19,Duke,10,9
9/19/2015,Arizona,77,Northern Arizona,13,64
9/19/2015,Ohio St,20,N Illinois,13,7
9/19/2015,W Michigan,52,Murray St,20,32
9/19/2015,Miami FL,36,Nebraska,33,3
9/19/2015,Michigan,28,UNLV,7,21
9/19/2015,Mississippi,43,Alabama,37,6
9/19/2015,Stanford,41,USC,31,10
9/19/2015,Temple,25,Massachusetts,23,2
9/19/2015,Arkansas St,70,Missouri St,7,63
9/19/2015,TCU,56,SMU,37,19
9/19/2015,Southern Miss,56,Texas St,50,6
9/19/2015,Mississippi St,62,Northwestern LA,13,49
9/19/2015,Marshall,45,Norfolk St,7,38
9/19/2015,Iowa,27,Pittsburgh,24,3
9/19/2015,Oregon St,35,San Jose St,21,14
9/19/2015,Georgia,52,South Carolina,20,32
9/19/2015,Penn St,28,Rutgers,3,25
9/19/2015,Rice,38,North Texas,24,14
9/19/2015,Toledo,30,Iowa St,23,7
9/19/2015,Minnesota,10,Kent,7,3
9/19/2015,Tulane,38,Maine,7,31
9/19/2015,Kansas St,39,Louisiana Tech,33,6
9/19/2015,Memphis,44,Bowling Green,41,3
9/19/2015,Florida,14,Kentucky,9,5
9/19/2015,Furman,16,UCF,15,1
9/19/2015,Notre Dame,30,Georgia Tech,22,8
9/19/2015,North Carolina,48,Illinois,14,34
9/19/2015,Syracuse,30,C Michigan,27,3
9/19/2015,Cincinnati,37,Miami OH,33,4
9/19/2015,UCLA,24,BYU,23,1
9/19/2015,California,45,Texas,44,1
9/19/2015,Ga Southern,48,Citadel,13,35
9/19/2015,Colorado,27,Colorado St,24,3
9/19/2015,Missouri,9,Connecticut,6,3
9/19/2015,Ball St,28,E Michigan,17,11
9/19/2015,Vanderbilt,47,Austin Peay,7,40
9/19/2015,LSU,45,Auburn,21,24
9/19/2015,Michigan St,35,Air Force,21,14
9/19/2015,Tennessee,55,W Carolina,10,45
9/19/2015,Indiana,38,WKU,35,3
9/19/2015,Virginia,35,William & Mary,29,6
9/19/2015,Wisconsin,28,Troy,3,25
9/19/2015,Buffalo,33,FL Atlantic,15,18
9/19/2015,Washington St,31,Wyoming,14,17
9/19/2015,Virginia Tech,51,Purdue,24,27
9/19/2015,Wake Forest,17,Army,14,3
9/19/2015,Washington,31,Utah St,17,14
9/19/2015,Utah,45,Fresno St,24,21
9/19/2015,Oklahoma,52,Tulsa,38,14
9/19/2015,UTEP,50,New Mexico St,47,3
9/19/2015,Texas Tech,35,Arkansas,24,11
9/19/2015,South Alabama,34,San Diego St,27,7
9/19/2015,Oklahoma St,69,UT San Antonio,14,55
9/19/2015,Oregon,61,Georgia St,28,33
9/19/2015,Ohio,35,SE Louisiana,14,21
9/19/2015,Hawaii,47,UC Davis,27,20
9/19/2015,Florida Intl,39,NC Central,14,25
9/19/2015,Akron,52,Savannah St,9,43
9/19/2015,Maryland,35,South Florida,17,18
9/19/2015,MTSU,73,Charlotte,14,59
9/19/2015,Navy,45,East Carolina,21,24
9/19/2015,Idaho,41,Wofford,38,3
9/24/2015,Memphis,53,Cincinnati,46,7
9/25/2015,Boise St,56,Virginia,14,42
9/25/2015,Stanford,42,Oregon St,24,18
9/26/2015,Florida,28,Tennessee,27,1
9/26/2015,TCU,55,Texas Tech,52,3
9/26/2015,Texas A&M,28,Arkansas,21,7
9/26/2015,Nebraska,36,Southern Miss,28,8
9/26/2015,USC,42,Arizona St,14,28
9/26/2015,Georgia,48,Southern Univ,6,42
9/26/2015,Houston,59,Texas St,14,45
9/26/2015,Baylor,70,Rice,17,53
9/26/2015,Penn St,37,San Diego St,21,16
9/26/2015,Minnesota,27,Ohio,24,3
9/26/2015,Oklahoma St,30,Texas,27,3
9/26/2015,Mississippi St,17,Auburn,9,8
9/26/2015,Kentucky,21,Missouri,13,8
9/26/2015,Navy,28,Connecticut,18,10
9/26/2015,Notre Dame,62,Massachusetts,27,35
9/26/2015,WKU,56,Miami OH,14,42
9/26/2015,Illinois,27,MTSU,25,2
9/26/2015,Boston College,17,N Illinois,14,3
9/26/2015,Alabama,34,ULM,0,34
9/26/2015,Colorado,48,Nicholls St,0,48
9/26/2015,NC State,63,South Alabama,13,50
9/26/2015,Iowa,62,North Texas,16,46
9/26/2015,Nevada,24,Buffalo,21,3
9/26/2015,New Mexico,38,Wyoming,28,10
9/26/2015,Northwestern,24,Ball St,19,5
9/26/2015,Army,58,E Michigan,36,22
9/26/2015,Akron,35,ULL,14,21
9/26/2015,Toledo,37,Arkansas St,7,30
9/26/2015,Appalachian St,49,Old Dominion,0,49
9/26/2015,California,30,Washington,24,6
9/26/2015,Michigan,31,BYU,0,31
9/26/2015,Bowling Green,35,Purdue,28,7
9/26/2015,North Carolina,41,Delaware,14,27
9/26/2015,Michigan St,30,C Michigan,10,20
9/26/2015,Colorado St,33,UT San Antonio,31,2
9/26/2015,Indiana,31,Wake Forest,24,7
9/26/2015,Duke,34,Georgia Tech,20,14
9/26/2015,Wisconsin,28,Hawaii,0,28
9/26/2015,San Jose St,49,Fresno St,23,26
9/26/2015,Marshall,36,Kent,29,7
9/26/2015,West Virginia,45,Maryland,6,39
9/26/2015,LSU,34,Syracuse,24,10
9/26/2015,UNLV,80,Idaho St,8,72
9/26/2015,James Madison,48,SMU,45,3
9/26/2015,Rutgers,27,Kansas,14,13
9/26/2015,Ohio St,38,W Michigan,12,26
9/26/2015,Louisville,45,Samford,3,42
9/26/2015,South Carolina,31,UCF,14,17
9/26/2015,Utah,62,Oregon,20,42
9/26/2015,UCLA,56,Arizona,30,26
9/26/2015,Mississippi,27,Vanderbilt,16,11
9/26/2015,East Carolina,35,Virginia Tech,28,7
9/26/2015,FL Atlantic,17,Charlotte,7,10
9/26/2015,Louisiana Tech,27,Florida Intl,17,10
9/26/2015,UTEP,27,Incarnate Word,17,10
9/26/2015,Ga Southern,44,Idaho,20,24
10/1/2015,Cincinnati,34,Miami FL,23,11
10/2/2015,Memphis,24,South Florida,17,7
10/2/2015,BYU,30,Connecticut,13,17
10/2/2015,Temple,37,Charlotte,3,34
10/3/2015,Utah St,33,Colorado St,18,15
10/3/2015,East Carolina,49,SMU,23,26
10/3/2015,Bowling Green,28,Buffalo,22,6
10/3/2015,Arkansas,24,Tennessee,20,4
10/3/2015,Stanford,55,Arizona,17,38
10/3/2015,Arizona St,38,UCLA,23,15
10/3/2015,Alabama,38,Georgia,10,28
10/3/2015,Penn St,20,Army,14,6
10/3/2015,Duke,9,Boston College,7,2
10/3/2015,Ga Southern,51,ULM,31,20
10/3/2015,San Diego St,21,Fresno St,7,14
10/3/2015,LSU,44,E Michigan,22,22
10/3/2015,Kentucky,34,E Kentucky,27,7
10/3/2015,Florida St,24,Wake Forest,16,8
10/3/2015,Houston,38,Tulsa,24,14
10/3/2015,Boise St,55,Hawaii,0,55
10/3/2015,Arkansas St,49,Idaho,35,14
10/3/2015,Iowa,10,Wisconsin,6,4
10/3/2015,Oklahoma St,36,Kansas St,34,2
10/3/2015,Iowa St,38,Kansas,13,25
10/3/2015,Louisville,20,NC State,13,7
10/3/2015,Kent,20,Miami OH,14,6
10/3/2015,Michigan,28,Maryland,0,28
10/3/2015,Illinois,14,Nebraska,13,1
10/3/2015,UNLV,23,Nevada,17,6
10/3/2015,Texas A&M,30,Mississippi St,17,13
10/3/2015,Northwestern,27,Minnesota,0,27
10/3/2015,Florida,38,Mississippi,10,28
10/3/2015,New Mexico,38,New Mexico St,29,9
10/3/2015,North Carolina,38,Georgia Tech,31,7
10/3/2015,C Michigan,29,N Illinois,19,10
10/3/2015,Southern Miss,49,North Texas,14,35
10/3/2015,Clemson,24,Notre Dame,22,2
10/3/2015,Ohio St,34,Indiana,27,7
10/3/2015,Ohio,14,Akron,12,2
10/3/2015,Oregon,41,Colorado,24,17
10/3/2015,Missouri,24,South Carolina,10,14
10/3/2015,Auburn,35,San Jose St,21,14
10/3/2015,Pittsburgh,17,Virginia Tech,13,4
10/3/2015,Michigan St,24,Purdue,21,3
10/3/2015,Louisiana Tech,43,ULL,14,29
10/3/2015,TCU,50,Texas,7,43
10/3/2015,Marshall,27,Old Dominion,7,20
10/3/2015,South Alabama,24,Troy,18,6
10/3/2015,Massachusetts,24,Florida Intl,14,10
10/3/2015,UT San Antonio,25,UTEP,6,19
10/3/2015,Vanderbilt,17,MTSU,13,4
10/3/2015,Baylor,63,Texas Tech,35,28
10/3/2015,Toledo,24,Ball St,10,14
10/3/2015,Tulane,45,UCF,31,14
10/3/2015,Appalachian St,31,Wyoming,13,18
10/3/2015,Liberty,41,Georgia St,33,8
10/3/2015,Oklahoma,44,West Virginia,24,20
10/3/2015,WKU,49,Rice,10,39
10/3/2015,California,34,Washington St,28,6
10/3/2015,Navy,33,Air Force,11,22
10/8/2015,Houston,49,SMU,28,21
10/8/2015,Washington,17,USC,12,5
10/9/2015,Virginia Tech,28,NC State,13,15
10/9/2015,Marshall,31,Southern Miss,10,21
10/10/2015,Mississippi,52,New Mexico St,3,49
10/10/2015,Nevada,35,New Mexico,17,18
10/10/2015,Tulsa,34,ULM,24,10
10/10/2015,Michigan,38,Northwestern,0,38
10/10/2015,Notre Dame,41,Navy,24,17
10/10/2015,Ohio,34,Miami OH,3,31
10/10/2015,Florida St,29,Miami FL,24,5
10/10/2015,Michigan St,31,Rutgers,24,7
10/10/2015,Minnesota,41,Purdue,13,28
10/10/2015,WKU,58,MTSU,28,30
10/10/2015,ULL,49,Texas St,27,22
10/10/2015,South Florida,45,Syracuse,24,21
10/10/2015,TCU,52,Kansas St,45,7
10/10/2015,Rice,27,FL Atlantic,26,1
10/10/2015,San Jose St,33,UNLV,27,6
10/10/2015,San Diego St,28,Hawaii,14,14
10/10/2015,Oklahoma St,33,West Virginia,26,7
10/10/2015,Texas,24,Oklahoma,17,7
10/10/2015,Arizona,44,Oregon St,7,37
10/10/2015,Akron,47,E Michigan,21,26
10/10/2015,Appalachian St,37,Georgia St,3,34
10/10/2015,Alabama,27,Arkansas,14,13
10/10/2015,Boise St,41,Colorado St,10,31
10/10/2015,Baylor,66,Kansas,7,59
10/10/2015,N Illinois,59,Ball St,41,18
10/10/2015,Utah,30,California,24,6
10/10/2015,W Michigan,41,C Michigan,39,2
10/10/2015,BYU,45,East Carolina,38,7
10/10/2015,Duke,44,Army,3,41
10/10/2015,Connecticut,40,UCF,13,27
10/10/2015,Arizona St,48,Colorado,23,25
10/10/2015,Louisiana Tech,34,UT San Antonio,31,3
10/10/2015,Ohio St,49,Maryland,28,21
10/10/2015,Bowling Green,62,Massachusetts,38,24
10/10/2015,LSU,45,South Carolina,24,21
10/10/2015,Toledo,38,Kent,7,31
10/10/2015,Texas Tech,66,Iowa St,31,35
10/10/2015,Penn St,29,Indiana,7,22
10/10/2015,Iowa,29,Illinois,20,9
10/10/2015,Clemson,43,Georgia Tech,24,19
10/10/2015,Florida,21,Missouri,3,18
10/10/2015,Tennessee,38,Georgia,31,7
10/10/2015,Wake Forest,3,Boston College,0,3
10/10/2015,Pittsburgh,26,Virginia,19,7
10/10/2015,Utah St,56,Fresno St,14,42
10/10/2015,Florida Intl,52,UTEP,12,40
10/10/2015,Temple,49,Tulane,10,39
10/10/2015,Washington St,45,Oregon,38,7
10/10/2015,Mississippi St,45,Troy,17,28
10/10/2015,Wisconsin,23,Nebraska,21,2
10/10/2015,Air Force,31,Wyoming,17,14
10/10/2015,Portland St,66,North Texas,7,59
10/13/2015,Arkansas St,49,South Alabama,31,18
10/15/2015,Auburn,30,Kentucky,27,3
10/15/2015,Stanford,56,UCLA,35,21
10/15/2015,WKU,55,North Texas,28,27
10/16/2015,Houston,42,Tulane,7,35
10/16/2015,Utah St,52,Boise St,26,26
10/16/2015,BYU,38,Cincinnati,24,14
10/16/2015,Fresno St,31,UNLV,28,3
10/17/2015,New Mexico,28,Hawaii,27,1
10/17/2015,Idaho,19,Troy,16,3
10/17/2015,LSU,35,Florida,28,7
10/17/2015,Toledo,63,E Michigan,20,43
10/17/2015,Iowa,40,Northwestern,10,30
10/17/2015,Kent,15,Massachusetts,10,5
10/17/2015,Marshall,33,FL Atlantic,17,16
10/17/2015,Mississippi St,45,Louisiana Tech,20,25
10/17/2015,Florida St,41,Louisville,21,20
10/17/2015,Clemson,34,Boston College,17,17
10/17/2015,Utah,34,Arizona St,18,16
10/17/2015,Arizona,38,Colorado,31,7
10/17/2015,Appalachian St,59,ULM,14,45
10/17/2015,Alabama,41,Texas A&M,23,18
10/17/2015,Bowling Green,59,Akron,10,49
10/17/2015,Colorado St,38,Air Force,23,15
10/17/2015,Army,21,Bucknell,14,7
10/17/2015,Ohio St,38,Penn St,10,28
10/17/2015,Oregon,26,Washington,20,6
10/17/2015,Washington St,52,Oregon St,31,21
10/17/2015,Oklahoma,55,Kansas St,0,55
10/17/2015,San Diego St,30,San Jose St,7,23
10/17/2015,Pittsburgh,31,Georgia Tech,28,3
10/17/2015,Rutgers,55,Indiana,52,3
10/17/2015,Wisconsin,24,Purdue,7,17
10/17/2015,TCU,45,Iowa St,21,24
10/17/2015,Virginia,44,Syracuse,38,6
10/17/2015,Notre Dame,41,USC,31,10
10/17/2015,Michigan St,27,Michigan,23,4
10/17/2015,Nebraska,48,Minnesota,25,23
10/17/2015,Memphis,37,Mississippi,24,13
10/17/2015,Georgia,9,Missouri,6,3
10/17/2015,N Illinois,45,Miami OH,12,33
10/17/2015,Wyoming,28,Nevada,21,7
10/17/2015,Ga Southern,56,New Mexico St,26,30
10/17/2015,East Carolina,30,Tulsa,17,13
10/17/2015,Texas Tech,30,Kansas,20,10
10/17/2015,South Carolina,19,Vanderbilt,10,9
10/17/2015,North Carolina,50,Wake Forest,14,36
10/17/2015,Miami FL,30,Virginia Tech,20,10
10/17/2015,Temple,30,UCF,16,14
10/17/2015,C Michigan,51,Buffalo,14,37
10/17/2015,Baylor,62,West Virginia,38,24
10/17/2015,W Michigan,49,Ohio,14,35
10/17/2015,South Florida,28,Connecticut,20,8
10/17/2015,MTSU,42,Florida Intl,34,8
10/17/2015,Georgia St,31,Ball St,19,12
10/17/2015,Southern Miss,32,UT San Antonio,10,22
10/17/2015,Old Dominion,37,Charlotte,34,3
10/20/2015,Arkansas St,37,ULL,27,10
10/22/2015,Temple,24,East Carolina,14,10
10/22/2015,UCLA,40,California,24,16
10/22/2015,Appalachian St,31,Ga Southern,13,18
10/23/2015,Memphis,66,Tulsa,42,24
10/23/2015,San Diego St,48,Utah St,14,34
10/24/2015,Mississippi St,42,Kentucky,16,26
10/24/2015,Baylor,45,Iowa St,27,18
10/24/2015,Texas,23,Kansas St,9,14
10/24/2015,Oklahoma St,58,Kansas,10,48
10/24/2015,Air Force,42,Fresno St,14,28
10/24/2015,N Illinois,49,E Michigan,21,28
10/24/2015,Georgia Tech,22,Florida St,16,6
10/24/2015,Houston,59,UCF,10,49
10/24/2015,Michigan St,52,Indiana,26,26
10/24/2015,Nevada,30,Hawaii,20,10
10/24/2015,Bowling Green,48,Kent,0,48
10/24/2015,C Michigan,23,Ball St,21,2
10/24/2015,Clemson,58,Miami FL,0,58
10/24/2015,Colorado,17,Oregon St,13,4
10/24/2015,Cincinnati,37,Connecticut,13,24
10/24/2015,Duke,45,Virginia Tech,43,2
10/24/2015,Louisville,17,Boston College,14,3
10/24/2015,Arkansas,54,Auburn,46,8
10/24/2015,Rice,38,Army,31,7
10/24/2015,Alabama,19,Tennessee,14,5
10/24/2015,Mississippi,23,Texas A&M,3,20
10/24/2015,South Florida,38,SMU,14,24
10/24/2015,Southern Miss,44,Charlotte,10,34
10/24/2015,Pittsburgh,23,Syracuse,20,3
10/24/2015,Penn St,31,Maryland,30,1
10/24/2015,San Jose St,31,New Mexico,21,10
10/24/2015,NC State,35,Wake Forest,17,18
10/24/2015,Marshall,30,North Texas,13,17
10/24/2015,Northwestern,30,Nebraska,28,2
10/24/2015,Buffalo,41,Ohio,17,24
10/24/2015,Ohio St,49,Rutgers,7,42
10/24/2015,Vanderbilt,10,Missouri,3,7
10/24/2015,Louisiana Tech,45,MTSU,16,29
10/24/2015,W Michigan,35,Miami OH,13,22
10/24/2015,Florida Intl,41,Old Dominion,12,29
10/24/2015,Texas St,36,South Alabama,18,18
10/24/2015,UTEP,27,FL Atlantic,17,10
10/24/2015,LSU,48,WKU,20,28
10/24/2015,Troy,52,New Mexico St,7,45
10/24/2015,BYU,70,Wagner,6,64
10/24/2015,Boise St,34,Wyoming,14,20
10/24/2015,Wisconsin,24,Illinois,13,11
10/24/2015,Stanford,31,Washington,14,17
10/24/2015,Washington St,45,Arizona,42,3
10/24/2015,USC,42,Utah,24,18
10/24/2015,North Carolina,26,Virginia,13,13
10/24/2015,Oklahoma,63,Texas Tech,27,36
10/24/2015,Toledo,51,Massachusetts,35,16
10/24/2015,Navy,31,Tulane,14,17
10/24/2015,Idaho,27,ULM,13,14
10/29/2015,North Carolina,26,Pittsburgh,19,7
10/29/2015,Oregon,61,Arizona St,55,6
10/29/2015,Ga Southern,37,Texas St,13,24
10/29/2015,Buffalo,29,Miami OH,24,5
10/29/2015,TCU,40,West Virginia,10,30
10/29/2015,W Michigan,58,E Michigan,28,30
10/30/2015,Connecticut,31,East Carolina,13,18
10/30/2015,Louisville,20,Wake Forest,19,1
10/30/2015,Louisiana Tech,42,Rice,17,25
10/30/2015,Utah St,58,Wyoming,27,31
10/31/2015,Marshall,34,Charlotte,10,24
10/31/2015,Ball St,20,Massachusetts,10,10
10/31/2015,Iowa,31,Maryland,15,16
10/31/2015,Virginia,27,Georgia Tech,21,6
10/31/2015,Penn St,39,Illinois,0,39
10/31/2015,New Mexico St,55,Idaho,48,7
10/31/2015,Florida,27,Georgia,3,24
10/31/2015,UCLA,35,Colorado,31,4
10/31/2015,Clemson,56,NC State,41,15
10/31/2015,C Michigan,14,Akron,6,8
10/31/2015,Boise St,55,UNLV,27,28
10/31/2015,Air Force,58,Hawaii,7,51
10/31/2015,Washington,49,Arizona,3,46
10/31/2015,Texas A&M,35,South Carolina,28,7
10/31/2015,USC,27,California,21,6
10/31/2015,Iowa St,24,Texas,0,24
10/31/2015,Tennessee,52,Kentucky,21,31
10/31/2015,Stanford,30,Washington St,28,2
10/31/2015,Florida St,45,Syracuse,21,24
10/31/2015,Oklahoma St,70,Texas Tech,53,17
10/31/2015,Oklahoma,62,Kansas,7,55
10/31/2015,Utah,27,Oregon St,12,15
10/31/2015,Wisconsin,48,Rutgers,10,38
10/31/2015,San Diego St,41,Colorado St,17,24
10/31/2015,ULL,30,ULM,24,6
10/31/2015,Notre Dame,24,Temple,20,4
10/31/2015,Michigan,29,Minnesota,26,3
10/31/2015,Miami FL,30,Duke,27,3
10/31/2015,Mississippi,27,Auburn,19,8
10/31/2015,Purdue,55,Nebraska,45,10
10/31/2015,WKU,55,Old Dominion,30,25
10/31/2015,Appalachian St,44,Troy,41,3
10/31/2015,Cincinnati,52,UCF,7,45
10/31/2015,Arkansas,63,TN Martin,28,35
10/31/2015,Memphis,41,Tulane,13,28
10/31/2015,Tulsa,40,SMU,31,9
10/31/2015,Southern Miss,34,UTEP,13,21
10/31/2015,Houston,34,Vanderbilt,0,34
10/31/2015,Virginia Tech,26,Boston College,10,16
10/31/2015,Arkansas St,48,Georgia St,34,14
10/31/2015,FL Atlantic,31,Florida Intl,17,14
10/31/2015,North Texas,30,UT San Antonio,23,7
10/31/2015,Navy,29,South Florida,17,12
11/3/2015,N Illinois,32,Toledo,27,5
11/4/2015,Bowling Green,62,Ohio,24,38
11/5/2015,Mississippi St,31,Missouri,13,18
11/5/2015,Arkansas St,40,Appalachian St,27,13
11/5/2015,Baylor,31,Kansas St,24,7
11/5/2015,W Michigan,54,Ball St,7,47
11/5/2015,Buffalo,18,Kent,17,1
11/5/2015,Nevada,30,Fresno St,16,14
11/6/2015,Temple,60,SMU,40,20
11/6/2015,UTEP,24,Rice,21,3
11/6/2015,BYU,17,San Jose St,16,1
11/7/2015,Oklahoma St,49,TCU,29,20
11/7/2015,Louisville,41,Syracuse,17,24
11/7/2015,Stanford,42,Colorado,10,32
11/7/2015,Tennessee,27,South Carolina,24,3
11/7/2015,ULL,23,Georgia St,21,2
11/7/2015,Michigan,49,Rutgers,16,33
11/7/2015,Northwestern,23,Penn St,21,2
11/7/2015,Navy,45,Memphis,20,25
11/7/2015,Nebraska,39,Michigan St,38,1
11/7/2015,Ohio St,28,Minnesota,14,14
11/7/2015,Notre Dame,42,Pittsburgh,30,12
11/7/2015,Troy,51,ULM,14,37
11/7/2015,NC State,24,Boston College,8,16
11/7/2015,Louisiana Tech,56,North Texas,13,43
11/7/2015,New Mexico St,31,Texas St,21,10
11/7/2015,Air Force,20,Army,3,17
11/7/2015,Auburn,26,Texas A&M,10,16
11/7/2015,Arkansas,53,Mississippi,52,1
11/7/2015,USC,38,Arizona,30,8
11/7/2015,Washington St,38,Arizona St,24,14
11/7/2015,Akron,17,Massachusetts,13,4
11/7/2015,Houston,33,Cincinnati,30,3
11/7/2015,Oregon,44,California,28,16
11/7/2015,Colorado St,26,Wyoming,7,19
11/7/2015,Connecticut,7,Tulane,3,4
11/7/2015,North Carolina,66,Duke,31,35
11/7/2015,Clemson,23,Florida St,13,10
11/7/2015,Miami OH,28,E Michigan,13,15
11/7/2015,South Alabama,52,Idaho,45,7
11/7/2015,Illinois,48,Purdue,14,34
11/7/2015,UNLV,41,Hawaii,21,20
11/7/2015,MTSU,27,Marshall,24,3
11/7/2015,Alabama,30,LSU,16,14
11/7/2015,Texas,59,Kansas,20,39
11/7/2015,Oklahoma,52,Iowa St,16,36
11/7/2015,Iowa,35,Indiana,27,8
11/7/2015,Georgia,27,Kentucky,3,24
11/7/2015,Tulsa,45,UCF,30,15
11/7/2015,New Mexico,14,Utah St,13,1
11/7/2015,Miami FL,27,Virginia,21,6
11/7/2015,Florida,9,Vanderbilt,7,2
11/7/2015,West Virginia,31,Texas Tech,26,5
11/7/2015,UCLA,41,Oregon St,0,41
11/7/2015,Utah,34,Washington,23,11
11/7/2015,Wisconsin,31,Maryland,24,7
11/7/2015,South Florida,22,East Carolina,17,5
11/7/2015,WKU,35,FL Atlantic,19,16
11/7/2015,Old Dominion,36,UT San Antonio,31,5
11/7/2015,Florida Intl,48,Charlotte,31,17
11/10/2015,Toledo,28,C Michigan,23,5
11/10/2015,Ohio,27,Kent,0,27
11/11/2015,Bowling Green,41,W Michigan,27,14
11/11/2015,N Illinois,41,Buffalo,30,11
11/12/2015,South Alabama,32,ULL,25,7
11/12/2015,Virginia Tech,23,Georgia Tech,21,2
11/13/2015,USC,27,Colorado,24,3
11/14/2015,Southern Miss,65,Rice,10,55
11/14/2015,South Florida,44,Temple,23,21
11/14/2015,West Virginia,38,Texas,20,18
11/14/2015,California,54,Oregon St,24,30
11/14/2015,Pittsburgh,31,Duke,13,18
11/14/2015,Oklahoma,44,Baylor,34,10
11/14/2015,Oklahoma St,35,Iowa St,31,4
11/14/2015,Oregon,38,Stanford,36,2
11/14/2015,Northwestern,21,Purdue,14,7
11/14/2015,Nevada,37,San Jose St,34,3
11/14/2015,Ohio St,28,Illinois,3,25
11/14/2015,New Mexico,31,Boise St,24,7
11/14/2015,Tennessee,24,North Texas,0,24
11/14/2015,Florida St,34,NC State,17,17
11/14/2015,Iowa,40,Minnesota,35,5
11/14/2015,MTSU,24,FL Atlantic,17,7
11/14/2015,North Carolina,59,Miami FL,21,38
11/14/2015,Houston,35,Memphis,34,1
11/14/2015,Michigan,48,Indiana,41,7
11/14/2015,Nebraska,31,Rutgers,14,17
11/14/2015,Colorado St,49,UNLV,35,14
11/14/2015,Missouri,20,BYU,16,4
11/14/2015,Clemson,37,Syracuse,27,10
11/14/2015,Akron,37,Miami OH,28,9
11/14/2015,Alabama,31,Mississippi St,6,25
11/14/2015,Appalachian St,47,Idaho,20,27
11/14/2015,Arkansas,31,LSU,14,17
11/14/2015,Arkansas St,59,ULM,21,38
11/14/2015,Texas Tech,59,Kansas St,44,15
11/14/2015,TCU,23,Kansas,17,6
11/14/2015,Vanderbilt,21,Kentucky,17,4
11/14/2015,Michigan St,24,Maryland,7,17
11/14/2015,Massachusetts,28,E Michigan,17,11
11/14/2015,Florida,24,South Carolina,14,10
11/14/2015,Georgia,20,Auburn,13,7
11/14/2015,Fresno St,42,Hawaii,14,28
11/14/2015,Ga Southern,45,Troy,10,35
11/14/2015,Notre Dame,28,Wake Forest,7,21
11/14/2015,Arizona St,27,Washington,17,10
11/14/2015,Arizona,37,Utah,30,7
11/14/2015,Louisville,38,Virginia,31,7
11/14/2015,Tulane,34,Army,31,3
11/14/2015,Old Dominion,31,UTEP,21,10
11/14/2015,Air Force,35,Utah St,28,7
11/14/2015,Cincinnati,49,Tulsa,38,11
11/14/2015,San Diego St,38,Wyoming,3,35
11/14/2015,Texas A&M,41,W Carolina,17,24
11/14/2015,Washington St,31,UCLA,27,4
11/14/2015,UT San Antonio,30,Charlotte,27,3
11/14/2015,Marshall,52,Florida Intl,0,52
11/14/2015,Georgia St,41,Texas St,19,22
11/14/2015,Navy,55,SMU,14,41
11/17/2015,Ohio,48,Ball St,31,17
11/17/2015,Toledo,44,Bowling Green,28,16
11/18/2015,N Illinois,27,W Michigan,19,8
11/18/2015,C Michigan,27,Kent,14,13
11/19/2015,East Carolina,44,UCF,7,37
11/19/2015,Texas St,16,ULM,3,13
11/20/2015,South Florida,65,Cincinnati,27,38
11/20/2015,Air Force,37,Boise St,30,7
11/21/2015,Citadel,23,South Carolina,22,1
11/21/2015,Stanford,35,California,22,13
11/21/2015,Virginia,42,Duke,34,8
11/21/2015,Colorado St,28,New Mexico,21,7
11/21/2015,Washington St,27,Colorado,3,24
11/21/2015,Baylor,45,Oklahoma St,35,10
11/21/2015,Arizona St,52,Arizona,37,15
11/21/2015,BYU,52,Fresno St,10,42
11/21/2015,Miami FL,38,Georgia Tech,21,17
11/21/2015,Georgia,23,Ga Southern,17,6
11/21/2015,Connecticut,20,Houston,17,3
11/21/2015,Minnesota,32,Illinois,23,9
11/21/2015,Indiana,47,Maryland,28,19
11/21/2015,Auburn,56,Idaho,34,22
11/21/2015,Temple,31,Memphis,12,19
11/21/2015,Louisiana Tech,17,UTEP,15,2
11/21/2015,Pittsburgh,45,Louisville,34,11
11/21/2015,Kansas St,38,Iowa St,35,3
11/21/2015,Mississippi,38,LSU,17,21
11/21/2015,Notre Dame,19,Boston College,16,3
11/21/2015,Northwestern,13,Wisconsin,7,6
11/21/2015,North Carolina,30,Virginia Tech,27,3
11/21/2015,MTSU,41,North Texas,7,34
11/21/2015,New Mexico St,37,ULL,34,3
11/21/2015,Navy,44,Tulsa,21,23
11/21/2015,Utah St,31,Nevada,27,4
11/21/2015,Mississippi St,51,Arkansas,50,1
11/21/2015,Michigan,28,Penn St,16,12
11/21/2015,Michigan St,17,Ohio St,14,3
11/21/2015,Miami OH,20,Massachusetts,13,7
11/21/2015,Oregon,48,USC,28,20
11/21/2015,Oklahoma,30,TCU,29,1
11/21/2015,Texas A&M,25,Vanderbilt,0,25
11/21/2015,NC State,42,Syracuse,29,13
11/21/2015,Tennessee,19,Missouri,8,11
11/21/2015,Florida St,52,Chattanooga,13,39
11/21/2015,San Jose St,42,Hawaii,23,19
11/21/2015,Rutgers,31,Army,21,10
11/21/2015,San Diego St,52,UNLV,14,38
11/21/2015,Iowa,40,Purdue,20,20
11/21/2015,UT San Antonio,34,Rice,24,10
11/21/2015,WKU,63,Florida Intl,7,56
11/21/2015,West Virginia,49,Kansas,0,49
11/21/2015,Akron,42,Buffalo,21,21
11/21/2015,SMU,49,Tulane,21,28
11/21/2015,UCLA,17,Utah,9,8
11/21/2015,Washington,52,Oregon St,7,45
11/21/2015,Clemson,33,Wake Forest,13,20
11/21/2015,Southern Miss,56,Old Dominion,31,25
11/21/2015,Georgia St,24,South Alabama,10,14
11/21/2015,Florida,20,FL Atlantic,14,6
11/21/2015,Alabama,56,Charleston So,6,50
11/21/2015,Kentucky,58,Charlotte,10,48
11/24/2015,Ohio,26,N Illinois,21,5
11/24/2015,Bowling Green,48,Ball St,10,38
11/26/2015,Texas Tech,48,Texas,45,3
11/26/2015,South Florida,44,UCF,3,41
11/27/2015,W Michigan,35,Toledo,30,5
11/27/2015,Washington,45,Washington St,10,35
11/27/2015,TCU,28,Baylor,21,7
11/27/2015,Akron,20,Kent,0,20
11/27/2015,Iowa,28,Nebraska,20,8
11/27/2015,Massachusetts,31,Buffalo,26,5
11/27/2015,C Michigan,35,E Michigan,28,7
11/27/2015,Oregon,52,Oregon St,42,10
11/27/2015,Miami FL,29,Pittsburgh,24,5
11/27/2015,Arkansas,28,Missouri,3,25
11/27/2015,Houston,52,Navy,31,21
11/27/2015,WKU,49,Marshall,28,21
11/27/2015,Boise St,40,San Jose St,23,17
11/27/2015,Georgia St,31,Troy,21,10
11/27/2015,Tulsa,45,Tulane,34,11
11/28/2015,Michigan St,55,Penn St,16,39
11/28/2015,Oklahoma,58,Oklahoma St,23,35
11/28/2015,LSU,19,Texas A&M,7,12
11/28/2015,Memphis,63,SMU,0,63
11/28/2015,Southern Miss,58,Louisiana Tech,24,34
11/28/2015,Appalachian St,28,ULL,7,21
11/28/2015,Stanford,38,Notre Dame,36,2
11/28/2015,Ohio St,42,Michigan,13,29
11/28/2015,Hawaii,28,ULM,26,2
11/28/2015,Northwestern,24,Illinois,14,10
11/28/2015,San Diego St,31,Nevada,14,17
11/28/2015,North Carolina,45,NC State,34,11
11/28/2015,MTSU,42,UT San Antonio,7,35
11/28/2015,Mississippi,38,Mississippi St,27,11
11/28/2015,Wyoming,35,UNLV,28,7
11/28/2015,Florida St,27,Florida,2,25
11/28/2015,Georgia,13,Georgia Tech,7,6
11/28/2015,Indiana,54,Purdue,36,18
11/28/2015,Maryland,46,Rutgers,41,5
11/28/2015,Louisville,38,Kentucky,24,14
11/28/2015,Kansas St,45,Kansas,14,31
11/28/2015,West Virginia,30,Iowa St,6,24
11/28/2015,Syracuse,20,Boston College,17,3
11/28/2015,Arkansas St,52,New Mexico St,28,24
11/28/2015,New Mexico,47,Air Force,35,12
11/28/2015,Alabama,29,Auburn,13,16
11/28/2015,California,48,Arizona St,46,2
11/28/2015,Utah,20,Colorado,14,6
11/28/2015,Clemson,37,South Carolina,32,5
11/28/2015,Colorado St,34,Fresno St,31,3
11/28/2015,Duke,27,Wake Forest,21,6
11/28/2015,Temple,27,Connecticut,3,24
11/28/2015,BYU,51,Utah St,28,23
11/28/2015,Cincinnati,19,East Carolina,16,3
11/28/2015,FL Atlantic,33,Old Dominion,31,2
11/28/2015,Ga Southern,55,South Alabama,17,38
11/28/2015,Rice,27,Charlotte,7,20
11/28/2015,Wisconsin,31,Minnesota,21,10
11/28/2015,UTEP,20,North Texas,17,3
11/28/2015,USC,40,UCLA,21,19
11/28/2015,Virginia Tech,23,Virginia,20,3
11/28/2015,Tennessee,53,Vanderbilt,28,25
11/28/2015,Idaho,38,Texas St,31,7
12/4/2015,Bowling Green,34,N Illinois,14,20
12/5/2015,Georgia St,34,Ga Southern,7,27
12/5/2015,Troy,41,ULL,17,24
12/5/2015,Kansas St,24,West Virginia,23,1
12/5/2015,Arkansas St,55,Texas St,17,38
12/5/2015,Texas,23,Baylor,17,6
12/5/2015,ULM,42,New Mexico St,35,7
12/5/2015,Appalachian St,34,South Alabama,27,7
12/5/2015,Alabama,29,Florida,15,14
12/5/2015,Stanford,41,USC,22,19
12/5/2015,Michigan St,16,Iowa,13,3
12/5/2015,Clemson,45,North Carolina,37,8
12/5/2015,Houston,24,Temple,13,11
12/5/2015,WKU,45,Southern Miss,28,17
12/5/2015,San Diego St,27,Air Force,24,3
12/12/2015,Navy,21,Army,17,4
12/19/2015,Appalachian St,31,Ohio,29,2
12/19/2015,San Jose St,27,Georgia St,16,11
12/19/2015,Utah,35,BYU,28,7
12/19/2015,Arizona,45,New Mexico,37,8
12/19/2015,Louisiana Tech,47,Arkansas St,28,19
12/21/2015,WKU,45,South Florida,35,10
12/22/2015,Akron,23,Utah St,21,2
12/22/2015,Toledo,32,Temple,17,15
12/23/2015,Ga Southern,58,Bowling Green,27,31
12/23/2015,Boise St,55,N Illinois,7,48
12/24/2015,W Michigan,45,MTSU,31,14
12/24/2015,San Diego St,42,Cincinnati,7,35
12/26/2015,Nebraska,37,UCLA,29,8
12/26/2015,Washington,44,Southern Miss,31,13
12/26/2015,Virginia Tech,55,Tulsa,52,3
12/26/2015,Duke,44,Indiana,41,3
12/26/2015,Marshall,16,Connecticut,10,6
12/26/2015,Washington St,20,Miami FL,14,6
12/28/2015,Minnesota,21,C Michigan,14,7
12/28/2015,Navy,44,Pittsburgh,28,16
12/29/2015,California,55,Air Force,36,19
12/29/2015,Baylor,49,North Carolina,38,11
12/29/2015,LSU,56,Texas Tech,27,29
12/29/2015,Nevada,28,Colorado St,23,5
12/30/2015,Mississippi St,51,NC State,28,23
12/30/2015,Auburn,31,Memphis,10,21
12/30/2015,Wisconsin,23,USC,21,2
12/30/2015,Louisville,27,Texas A&M,21,6
12/31/2015,Houston,38,Florida St,24,14
12/31/2015,Alabama,38,Michigan St,0,38
12/31/2015,Clemson,37,Oklahoma,17,20
1/1/2016,Ohio St,44,Notre Dame,28,16
1/1/2016,Tennessee,45,Northwestern,6,39
1/1/2016,Michigan,41,Florida,7,34
1/1/2016,Stanford,45,Iowa,16,29
1/1/2016,Mississippi,48,Oklahoma St,20,28
1/2/2016,TCU,47,Oregon,41,6
1/2/2016,West Virginia,43,Arizona St,42,1
1/2/2016,Arkansas,45,Kansas St,23,22
1/2/2016,Georgia,24,Penn St,17,7
1/11/2016,Alabama,45,Clemson,40,5
