Date,Team,Score,Team,Score,Margin
8/27/2014,Georgia St,38,Abilene Chr,37,1
8/28/2014,Akron,41,Howard,0,41
8/28/2014,C Michigan,20,Chattanooga,16,4
8/28/2014,Minnesota,42,E Illinois,20,22
8/28/2014,N Illinois,55,Presbyterian,3,52
8/28/2014,Tulsa,38,Tulane,31,7
8/28/2014,Utah,56,Idaho St,14,42
8/28/2014,Arizona St,45,Weber St,14,31
8/28/2014,Rutgers,41,Washington St,38,3
8/28/2014,Texas A&M,52,South Carolina,28,24
8/28/2014,ULM,17,Wake Forest,10,7
8/28/2014,New Mexico St,28,Cal Poly SLO,10,18
8/28/2014,Mississippi,35,Boise St,13,22
8/28/2014,Temple,37,Vanderbilt,7,30
8/28/2014,San Jose St,42,North Dakota,10,32
8/29/2014,Michigan St,45,Jacksonville St,7,38
8/29/2014,Syracuse,27,Villanova,26,1
8/29/2014,WKU,59,Bowling Green,31,28
8/29/2014,Colorado St,31,Colorado,17,14
8/29/2014,BYU,35,Connecticut,10,25
8/29/2014,UT San Antonio,27,Houston,7,20
8/29/2014,Arizona,58,UNLV,13,45
8/30/2014,Penn St,26,UCF,24,2
8/30/2014,Ball St,30,Colgate,10,20
8/30/2014,Buffalo,38,Duquesne,28,10
8/30/2014,Duke,52,Elon,13,39
8/30/2014,East Carolina,52,NC Central,7,45
8/30/2014,E Michigan,31,Morgan St,28,3
8/30/2014,Bethune-Cookman,14,Florida Intl,12,2
8/30/2014,Georgia Tech,38,Wofford,19,19
8/30/2014,Indiana,28,Indiana St,10,18
8/30/2014,Ohio,17,Kent,14,3
8/30/2014,Kentucky,59,TN Martin,14,45
8/30/2014,Maryland,52,James Madison,7,45
8/30/2014,Boston College,30,Massachusetts,7,23
8/30/2014,Marshall,42,Miami OH,27,15
8/30/2014,Michigan,52,Appalachian St,14,38
8/30/2014,North Carolina,56,Liberty,29,27
8/30/2014,NC State,24,Ga Southern,23,1
8/30/2014,Old Dominion,41,Hampton,28,13
8/30/2014,Pittsburgh,62,Delaware,0,62
8/30/2014,Purdue,43,W Michigan,34,9
8/30/2014,South Florida,36,W Carolina,31,5
8/30/2014,Toledo,54,New Hampshire,20,34
8/30/2014,Virginia Tech,34,William & Mary,9,25
8/30/2014,Georgia,45,Clemson,21,24
8/30/2014,Ohio St,34,Navy,17,17
8/30/2014,UCLA,28,Virginia,20,8
8/30/2014,Arkansas St,37,Montana St,10,27
8/30/2014,Illinois,28,Youngstown St,17,11
8/30/2014,Iowa,31,Northern Iowa,23,8
8/30/2014,N Dakota St,34,Iowa St,14,20
8/30/2014,Kansas St,55,SF Austin,16,39
8/30/2014,ULL,45,Southern Univ,6,39
8/30/2014,Memphis,63,Austin Peay,0,63
8/30/2014,MTSU,61,Savannah St,7,54
8/30/2014,Missouri,38,S Dakota St,18,20
8/30/2014,Nebraska,55,FL Atlantic,7,48
8/30/2014,California,31,Northwestern,24,7
8/30/2014,Oklahoma,48,Louisiana Tech,16,32
8/30/2014,TCU,48,Samford,14,34
8/30/2014,Texas,38,North Texas,7,31
8/30/2014,Texas St,65,Ark Pine Bluff,0,65
8/30/2014,Texas Tech,42,Cent Arkansas,35,7
8/30/2014,UAB,48,Troy,10,38
8/30/2014,Florida St,37,Oklahoma St,31,6
8/30/2014,Air Force,44,Nicholls St,16,28
8/30/2014,UTEP,31,New Mexico,24,7
8/30/2014,Wyoming,17,Montana,12,5
8/30/2014,Alabama,33,West Virginia,23,10
8/30/2014,Nevada,28,Southern Utah,19,9
8/30/2014,Oregon,62,South Dakota,13,49
8/30/2014,Oregon St,29,Portland St,14,15
8/30/2014,San Diego St,38,Northern Arizona,7,31
8/30/2014,Stanford,45,UC Davis,0,45
8/30/2014,USC,52,Fresno St,13,39
8/30/2014,Notre Dame,48,Rice,17,31
8/30/2014,Auburn,45,Arkansas,21,24
8/30/2014,Mississippi St,49,Southern Miss,0,49
8/30/2014,Washington,17,Hawaii,16,1
8/30/2014,LSU,28,Wisconsin,24,4
8/31/2014,Baylor,45,SMU,0,45
8/31/2014,Tennessee,38,Utah St,7,31
9/1/2014,Louisville,31,Miami FL,13,18
9/4/2014,Arizona,26,UT San Antonio,23,3
9/5/2014,Pittsburgh,30,Boston College,20,10
9/5/2014,Nevada,24,Washington St,13,11
9/6/2014,Alabama,41,FL Atlantic,0,41
9/6/2014,Appalachian St,66,Campbell,0,66
9/6/2014,Army,47,Buffalo,39,8
9/6/2014,Bowling Green,48,VMI,7,41
9/6/2014,Clemson,73,S Carolina St,7,66
9/6/2014,Connecticut,19,Stony Brook,16,3
9/6/2014,Florida Intl,34,Wagner,3,31
9/6/2014,Florida St,37,Citadel,12,25
9/6/2014,New Mexico St,34,Georgia St,31,3
9/6/2014,South Alabama,23,Kent,13,10
9/6/2014,Kentucky,20,Ohio,3,17
9/6/2014,Louisville,66,Murray St,21,45
9/6/2014,Marshall,48,Rhode Island,7,41
9/6/2014,Colorado,41,Massachusetts,38,3
9/6/2014,Miami FL,41,Florida A&M,7,34
9/6/2014,E Kentucky,17,Miami OH,10,7
9/6/2014,North Carolina,31,San Diego St,27,4
9/6/2014,NC State,46,Old Dominion,34,12
9/6/2014,Penn St,21,Akron,3,18
9/6/2014,C Michigan,38,Purdue,17,21
9/6/2014,Rutgers,38,Howard,25,13
9/6/2014,South Carolina,33,East Carolina,23,10
9/6/2014,Maryland,24,South Florida,17,7
9/6/2014,Navy,31,Temple,24,7
9/6/2014,Tennessee,34,Arkansas St,19,15
9/6/2014,Virginia,45,Richmond,13,32
9/6/2014,Wake Forest,23,Gardner Webb,7,16
9/6/2014,West Virginia,54,Towson,0,54
9/6/2014,Missouri,49,Toledo,24,25
9/6/2014,Auburn,59,San Jose St,13,46
9/6/2014,Baylor,70,Northwestern LA,6,64
9/6/2014,Houston,47,Grambling,0,47
9/6/2014,Illinois,42,WKU,34,8
9/6/2014,Iowa,17,Ball St,13,4
9/6/2014,Kansas St,32,Iowa St,28,4
9/6/2014,Kansas,34,SE Missouri St,28,6
9/6/2014,Louisiana Tech,48,ULL,20,28
9/6/2014,Minnesota,35,MTSU,24,11
9/6/2014,Mississippi St,47,UAB,34,13
9/6/2014,Nebraska,31,McNeese St,24,7
9/6/2014,North Texas,43,SMU,6,37
9/6/2014,N Illinois,23,Northwestern,15,8
9/6/2014,Oklahoma St,40,Missouri St,23,17
9/6/2014,Southern Miss,26,Alcorn St,20,6
9/6/2014,BYU,41,Texas,7,34
9/6/2014,Georgia Tech,38,Tulane,21,17
9/6/2014,Mississippi,41,Vanderbilt,3,38
9/6/2014,Wisconsin,37,W Illinois,3,34
9/6/2014,Oklahoma,52,Tulsa,7,45
9/6/2014,Duke,34,Troy,17,17
9/6/2014,Texas Tech,30,UTEP,26,4
9/6/2014,Utah,59,Fresno St,27,32
9/6/2014,Wyoming,17,Air Force,13,4
9/6/2014,California,55,CS Sacramento,14,41
9/6/2014,UCLA,42,Memphis,35,7
9/6/2014,UNLV,13,N Colorado,12,1
9/6/2014,Washington,59,E Washington,52,7
9/6/2014,Oregon,46,Michigan St,27,19
9/6/2014,USC,13,Stanford,10,3
9/6/2014,Arkansas,73,Nicholls St,7,66
9/6/2014,Florida,65,E Michigan,0,65
9/6/2014,Ga Southern,83,Savannah St,9,74
9/6/2014,ULM,38,Idaho,31,7
9/6/2014,Arizona St,58,New Mexico,23,35
9/6/2014,LSU,56,Sam Houston St,0,56
9/6/2014,Notre Dame,31,Michigan,0,31
9/6/2014,Texas A&M,73,Lamar,3,70
9/6/2014,Virginia Tech,35,Ohio St,21,14
9/6/2014,Utah St,40,Idaho St,20,20
9/6/2014,Boise St,37,Colorado St,24,13
9/6/2014,Oregon St,38,Hawaii,30,8
9/11/2014,Louisiana Tech,42,North Texas,21,21
9/11/2014,BYU,33,Houston,25,8
9/12/2014,Baylor,63,Buffalo,21,42
9/12/2014,Cincinnati,58,Toledo,34,24
9/13/2014,Indiana St,27,Ball St,20,7
9/13/2014,Bowling Green,45,Indiana,42,3
9/13/2014,Syracuse,40,C Michigan,3,37
9/13/2014,Boise St,38,Connecticut,21,17
9/13/2014,Duke,41,Kansas,3,38
9/13/2014,Pittsburgh,42,Florida Intl,25,17
9/13/2014,FL Atlantic,50,Tulsa,21,29
9/13/2014,Air Force,48,Georgia St,38,10
9/13/2014,Georgia Tech,42,Ga Southern,38,4
9/13/2014,Marshall,44,Ohio,14,30
9/13/2014,West Virginia,40,Maryland,37,3
9/13/2014,Miami FL,41,Arkansas St,20,21
9/13/2014,Michigan,34,Miami OH,10,24
9/13/2014,Ohio St,66,Kent,0,66
9/13/2014,Old Dominion,17,E Michigan,3,14
9/13/2014,South Carolina,38,Georgia,35,3
9/13/2014,NC State,49,South Florida,17,32
9/13/2014,East Carolina,28,Virginia Tech,21,7
9/13/2014,Missouri,38,UCF,10,28
9/13/2014,Virginia,23,Louisville,21,2
9/13/2014,Boston College,37,USC,31,6
9/13/2014,Alabama,52,Southern Miss,12,40
9/13/2014,Iowa St,20,Iowa,17,3
9/13/2014,LSU,31,ULM,0,31
9/13/2014,MTSU,50,WKU,47,3
9/13/2014,Oklahoma,34,Tennessee,10,24
9/13/2014,Oklahoma St,43,UT San Antonio,13,30
9/13/2014,Mississippi St,35,South Alabama,3,32
9/13/2014,TCU,30,Minnesota,7,23
9/13/2014,Texas A&M,38,Rice,10,28
9/13/2014,Navy,35,Texas St,21,14
9/13/2014,Arkansas,49,Texas Tech,28,21
9/13/2014,Abilene Chr,38,Troy,35,3
9/13/2014,Tulane,35,SE Louisiana,20,15
9/13/2014,UAB,41,Alabama A&M,14,27
9/13/2014,Vanderbilt,34,Massachusetts,31,3
9/13/2014,UCLA,20,Texas,17,3
9/13/2014,Colorado St,49,UC Davis,21,28
9/13/2014,UTEP,42,New Mexico St,24,18
9/13/2014,Arizona St,38,Colorado,24,14
9/13/2014,Arizona,35,Nevada,28,7
9/13/2014,W Michigan,45,Idaho,33,12
9/13/2014,Oregon,48,Wyoming,14,34
9/13/2014,Stanford,35,Army,0,35
9/13/2014,N Illinois,48,UNLV,34,14
9/13/2014,Washington,44,Illinois,19,25
9/13/2014,Washington St,59,Portland St,21,38
9/13/2014,Mississippi,56,ULL,15,41
9/13/2014,Hawaii,27,Northern Iowa,24,3
9/13/2014,Utah St,36,Wake Forest,24,12
9/13/2014,Florida,36,Kentucky,30,6
9/13/2014,Notre Dame,30,Purdue,14,16
9/13/2014,Penn St,13,Rutgers,10,3
9/13/2014,Nebraska,55,Fresno St,19,36
9/18/2014,Auburn,20,Kansas St,14,6
9/19/2014,South Florida,17,Connecticut,14,3
9/20/2014,Marshall,48,Akron,17,31
9/20/2014,Boston College,40,Maine,10,30
9/20/2014,Buffalo,36,Norfolk St,7,29
9/20/2014,Cincinnati,31,Miami OH,24,7
9/20/2014,Duke,47,Tulane,13,34
9/20/2014,East Carolina,70,North Carolina,41,29
9/20/2014,Georgia,66,Troy,0,66
9/20/2014,Utah,26,Michigan,10,16
9/20/2014,Michigan St,73,E Michigan,14,59
9/20/2014,NC State,42,Presbyterian,0,42
9/20/2014,Ohio,36,Idaho,24,12
9/20/2014,Penn St,48,Massachusetts,7,41
9/20/2014,Iowa,24,Pittsburgh,20,4
9/20/2014,Purdue,35,S Illinois,13,22
9/20/2014,Maryland,34,Syracuse,20,14
9/20/2014,Temple,59,Delaware St,0,59
9/20/2014,Toledo,34,Ball St,23,11
9/20/2014,UCF,41,Bethune-Cookman,7,34
9/20/2014,Georgia Tech,27,Virginia Tech,24,3
9/20/2014,Wake Forest,24,Army,21,3
9/20/2014,W Michigan,45,Murray St,14,31
9/20/2014,Oklahoma,45,West Virginia,33,12
9/20/2014,Florida St,23,Clemson,17,6
9/20/2014,Louisville,34,Florida Intl,3,31
9/20/2014,Alabama,42,Florida,21,21
9/20/2014,Arkansas,52,N Illinois,14,38
9/20/2014,Arkansas St,21,Utah St,14,7
9/20/2014,Illinois,42,Texas St,35,7
9/20/2014,Kansas,24,C Michigan,10,14
9/20/2014,Mississippi St,34,LSU,29,5
9/20/2014,Northwestern LA,30,Louisiana Tech,27,3
9/20/2014,Memphis,36,MTSU,17,19
9/20/2014,Minnesota,24,San Jose St,7,17
9/20/2014,Indiana,31,Missouri,27,4
9/20/2014,North Texas,77,Nicholls St,3,74
9/20/2014,Northwestern,24,W Illinois,7,17
9/20/2014,Old Dominion,45,Rice,42,3
9/20/2014,Ga Southern,28,South Alabama,6,22
9/20/2014,Southern Miss,21,Appalachian St,20,1
9/20/2014,Wisconsin,68,Bowling Green,17,51
9/20/2014,South Carolina,48,Vanderbilt,34,14
9/20/2014,Texas A&M,58,SMU,6,52
9/20/2014,BYU,41,Virginia,33,8
9/20/2014,Colorado,21,Hawaii,12,9
9/20/2014,Wyoming,20,FL Atlantic,19,1
9/20/2014,Arizona,49,California,45,4
9/20/2014,Fresno St,56,Southern Utah,16,40
9/20/2014,Oregon St,28,San Diego St,7,21
9/20/2014,Washington,45,Georgia St,14,31
9/20/2014,Oregon,38,Washington St,31,7
9/20/2014,Rutgers,31,Navy,24,7
9/20/2014,Nebraska,41,Miami FL,31,10
9/20/2014,New Mexico,38,New Mexico St,35,3
9/20/2014,Boise St,34,ULL,9,25
9/20/2014,Houston,47,UNLV,14,33
9/25/2014,Ga Southern,34,Appalachian St,14,20
9/25/2014,Oklahoma St,45,Texas Tech,35,10
9/25/2014,UCLA,62,Arizona St,27,35
9/26/2014,MTSU,41,Old Dominion,28,13
9/26/2014,Fresno St,35,New Mexico,24,11
9/27/2014,Colorado St,24,Boston College,21,3
9/27/2014,Buffalo,35,Miami OH,27,8
9/27/2014,Clemson,50,North Carolina,35,15
9/27/2014,Temple,36,Connecticut,10,26
9/27/2014,FL Atlantic,41,UT San Antonio,37,4
9/27/2014,Georgia,35,Tennessee,32,3
9/27/2014,Maryland,37,Indiana,15,22
9/27/2014,Louisville,20,Wake Forest,10,10
9/27/2014,Bowling Green,47,Massachusetts,42,5
9/27/2014,Minnesota,30,Michigan,14,16
9/27/2014,Michigan St,56,Wyoming,14,42
9/27/2014,Ohio,34,E Illinois,19,15
9/27/2014,Northwestern,29,Penn St,6,23
9/27/2014,Akron,21,Pittsburgh,10,11
9/27/2014,Iowa,24,Purdue,10,14
9/27/2014,Rutgers,31,Tulane,6,25
9/27/2014,Toledo,42,C Michigan,28,14
9/27/2014,Virginia,45,Kent,13,32
9/27/2014,Virginia Tech,35,W Michigan,17,18
9/27/2014,Yale,49,Army,43,6
9/27/2014,Florida St,56,NC State,41,15
9/27/2014,Missouri,21,South Carolina,20,1
9/27/2014,Notre Dame,31,Syracuse,15,16
9/27/2014,Miami FL,22,Duke,10,12
9/27/2014,Kentucky,17,Vanderbilt,7,10
9/27/2014,Auburn,45,Louisiana Tech,17,28
9/27/2014,Texas,23,Kansas,0,23
9/27/2014,Kansas St,58,UTEP,28,30
9/27/2014,LSU,63,New Mexico St,7,56
9/27/2014,Mississippi,24,Memphis,3,21
9/27/2014,TCU,56,SMU,0,56
9/27/2014,Rice,41,Southern Miss,23,18
9/27/2014,Texas A&M,35,Arkansas,28,7
9/27/2014,Texas St,37,Tulsa,34,3
9/27/2014,Florida Intl,34,UAB,20,14
9/27/2014,Wisconsin,27,South Florida,10,17
9/27/2014,Baylor,49,Iowa St,28,21
9/27/2014,Washington St,28,Utah,27,1
9/27/2014,California,59,Colorado,56,3
9/27/2014,South Alabama,34,Idaho,10,24
9/27/2014,San Diego St,34,UNLV,17,17
9/27/2014,USC,35,Oregon St,10,25
9/27/2014,Stanford,20,Washington,13,7
9/27/2014,WKU,36,Navy,27,9
9/27/2014,Ohio St,50,Cincinnati,28,22
9/27/2014,Air Force,28,Boise St,14,14
9/27/2014,ULM,22,Troy,20,2
9/27/2014,Nebraska,45,Illinois,14,31
9/27/2014,Nevada,21,San Jose St,10,11
10/2/2014,Florida Intl,38,FL Atlantic,10,28
10/2/2014,UCF,17,Houston,12,5
10/2/2014,Arizona,31,Oregon,24,7
10/3/2014,Louisville,28,Syracuse,6,22
10/3/2014,Utah St,35,BYU,20,15
10/3/2014,Fresno St,24,San Diego St,13,11
10/4/2014,Akron,31,E Michigan,6,25
10/4/2014,South Alabama,47,Appalachian St,21,26
10/4/2014,Army,33,Ball St,24,9
10/4/2014,Bowling Green,36,Buffalo,35,1
10/4/2014,C Michigan,28,Ohio,10,18
10/4/2014,Memphis,41,Cincinnati,14,27
10/4/2014,Clemson,41,NC State,0,41
10/4/2014,East Carolina,45,SMU,24,21
10/4/2014,Florida St,43,Wake Forest,3,40
10/4/2014,Georgia Tech,28,Miami FL,17,11
10/4/2014,Indiana,49,North Texas,24,25
10/4/2014,Miami OH,42,Massachusetts,41,1
10/4/2014,Virginia Tech,34,North Carolina,17,17
10/4/2014,Marshall,56,Old Dominion,14,42
10/4/2014,Florida,10,Tennessee,9,1
10/4/2014,Virginia,24,Pittsburgh,19,5
10/4/2014,West Virginia,33,Kansas,14,19
10/4/2014,Toledo,20,W Michigan,19,1
10/4/2014,Kentucky,45,South Carolina,38,7
10/4/2014,Ohio St,52,Maryland,24,28
10/4/2014,Georgia,44,Vanderbilt,17,27
10/4/2014,Arkansas St,28,ULM,14,14
10/4/2014,Purdue,38,Illinois,27,11
10/4/2014,Kansas St,45,Texas Tech,13,32
10/4/2014,ULL,34,Georgia St,31,3
10/4/2014,Louisiana Tech,55,UTEP,3,52
10/4/2014,MTSU,37,Southern Miss,31,6
10/4/2014,N Illinois,17,Kent,14,3
10/4/2014,Oklahoma St,37,Iowa St,20,17
10/4/2014,Rice,28,Hawaii,14,14
10/4/2014,Texas St,35,Idaho,30,5
10/4/2014,New Mexico,21,UT San Antonio,9,12
10/4/2014,UAB,42,WKU,39,3
10/4/2014,TCU,37,Oklahoma,33,4
10/4/2014,Mississippi,23,Alabama,17,6
10/4/2014,Baylor,28,Texas,7,21
10/4/2014,Auburn,41,LSU,7,34
10/4/2014,Mississippi St,48,Texas A&M,31,17
10/4/2014,Northwestern,20,Wisconsin,14,6
10/4/2014,Oregon St,36,Colorado,31,5
10/4/2014,Colorado St,42,Tulsa,17,25
10/4/2014,San Jose St,33,UNLV,10,23
10/4/2014,Utah,30,UCLA,28,2
10/4/2014,California,60,Washington St,59,1
10/4/2014,Arizona St,38,USC,34,4
10/4/2014,Air Force,30,Navy,21,9
10/4/2014,Notre Dame,17,Stanford,14,3
10/4/2014,Rutgers,26,Michigan,24,2
10/4/2014,Michigan St,27,Nebraska,22,5
10/4/2014,Ga Southern,36,New Mexico St,28,8
10/4/2014,Boise St,51,Nevada,46,5
10/9/2014,UCF,31,BYU,24,7
10/10/2014,Stanford,34,Washington St,17,17
10/10/2014,San Diego St,24,New Mexico,14,10
10/10/2014,UNLV,30,Fresno St,27,3
10/11/2014,Akron,29,Miami OH,19,10
10/11/2014,Liberty,55,Appalachian St,48,7
10/11/2014,Rice,41,Army,21,20
10/11/2014,W Michigan,42,Ball St,38,4
10/11/2014,E Michigan,37,Buffalo,27,10
10/11/2014,Arkansas St,52,Georgia St,10,42
10/11/2014,Iowa,45,Indiana,29,16
10/11/2014,Massachusetts,40,Kent,17,23
10/11/2014,Kentucky,48,ULM,14,34
10/11/2014,Marshall,49,MTSU,24,25
10/11/2014,Miami FL,55,Cincinnati,34,21
10/11/2014,Navy,51,VMI,14,37
10/11/2014,Boston College,30,NC State,14,16
10/11/2014,Bowling Green,31,Ohio,13,18
10/11/2014,East Carolina,28,South Florida,17,11
10/11/2014,Temple,35,Tulsa,24,11
10/11/2014,Tennessee,45,Chattanooga,10,35
10/11/2014,Florida St,38,Syracuse,20,18
10/11/2014,Michigan St,45,Purdue,31,14
10/11/2014,LSU,30,Florida,27,3
10/11/2014,Clemson,23,Louisville,17,6
10/11/2014,Duke,31,Georgia Tech,25,6
10/11/2014,Baylor,61,TCU,58,3
10/11/2014,Iowa St,37,Toledo,30,7
10/11/2014,Houston,28,Memphis,24,4
10/11/2014,Minnesota,24,Northwestern,17,7
10/11/2014,Georgia,34,Missouri,0,34
10/11/2014,C Michigan,34,N Illinois,17,17
10/11/2014,Oklahoma,31,Texas,26,5
10/11/2014,Mississippi,35,Texas A&M,20,15
10/11/2014,West Virginia,37,Texas Tech,34,3
10/11/2014,Troy,41,New Mexico St,24,17
10/11/2014,Tulane,12,Connecticut,3,9
10/11/2014,UAB,56,North Texas,21,35
10/11/2014,UT San Antonio,16,Florida Intl,13,3
10/11/2014,Vanderbilt,21,Charleston So,20,1
10/11/2014,Wisconsin,38,Illinois,28,10
10/11/2014,Mississippi St,38,Auburn,23,15
10/11/2014,Alabama,14,Arkansas,13,1
10/11/2014,Oklahoma St,27,Kansas,20,7
10/11/2014,UTEP,42,Old Dominion,35,7
10/11/2014,Utah St,34,Air Force,16,18
10/11/2014,Oregon,42,UCLA,30,12
10/11/2014,USC,28,Arizona,26,2
10/11/2014,Washington,31,California,7,24
10/11/2014,Notre Dame,50,North Carolina,43,7
10/11/2014,Ga Southern,47,Idaho,24,23
10/11/2014,Hawaii,38,Wyoming,28,10
10/11/2014,Michigan,18,Penn St,13,5
10/11/2014,Colorado St,31,Nevada,24,7
10/14/2014,ULL,34,Texas St,10,24
10/16/2014,Pittsburgh,21,Virginia Tech,16,5
10/16/2014,Utah,29,Oregon St,23,6
10/17/2014,Boise St,37,Fresno St,27,10
10/17/2014,Houston,31,Temple,10,21
10/18/2014,W Michigan,26,Bowling Green,14,12
10/18/2014,Ball St,32,C Michigan,29,3
10/18/2014,Duke,20,Virginia,13,7
10/18/2014,Marshall,45,Florida Intl,13,32
10/18/2014,FL Atlantic,45,WKU,38,7
10/18/2014,Kent,39,Army,17,22
10/18/2014,Louisville,30,NC State,18,12
10/18/2014,Maryland,38,Iowa,31,7
10/18/2014,Massachusetts,36,E Michigan,14,22
10/18/2014,Minnesota,39,Purdue,38,1
10/18/2014,North Carolina,48,Georgia Tech,43,5
10/18/2014,Ohio,23,Akron,20,3
10/18/2014,South Carolina,41,Furman,10,31
10/18/2014,UCF,20,Tulane,13,7
10/18/2014,Syracuse,30,Wake Forest,7,23
10/18/2014,Missouri,42,Florida,13,29
10/18/2014,Clemson,17,Boston College,13,4
10/18/2014,West Virginia,41,Baylor,27,14
10/18/2014,Florida St,31,Notre Dame,27,4
10/18/2014,Georgia,45,Arkansas,32,13
10/18/2014,LSU,41,Kentucky,3,38
10/18/2014,Louisiana Tech,27,UT San Antonio,20,7
10/18/2014,MTSU,34,UAB,22,12
10/18/2014,Southern Miss,30,North Texas,20,10
10/18/2014,N Illinois,51,Miami OH,41,10
10/18/2014,Kansas St,31,Oklahoma,30,1
10/18/2014,Mississippi,34,Tennessee,3,31
10/18/2014,Cincinnati,41,SMU,3,38
10/18/2014,South Alabama,30,Georgia St,27,3
10/18/2014,Texas,48,Iowa St,45,3
10/18/2014,Texas Tech,34,Kansas,21,13
10/18/2014,Appalachian St,53,Troy,14,39
10/18/2014,South Florida,38,Tulsa,30,8
10/18/2014,TCU,42,Oklahoma St,9,33
10/18/2014,Alabama,59,Texas A&M,0,59
10/18/2014,Air Force,35,New Mexico,31,4
10/18/2014,Nevada,42,BYU,35,7
10/18/2014,San Jose St,27,Wyoming,20,7
10/18/2014,Idaho,29,New Mexico St,17,12
10/18/2014,USC,56,Colorado,28,28
10/18/2014,Arizona St,26,Stanford,10,16
10/18/2014,UCLA,36,California,34,2
10/18/2014,Oregon,45,Washington,20,25
10/18/2014,Ohio St,56,Rutgers,17,39
10/18/2014,Michigan St,56,Indiana,17,39
10/18/2014,Colorado St,16,Utah St,13,3
10/18/2014,Nebraska,38,Northwestern,17,21
10/18/2014,San Diego St,20,Hawaii,10,10
10/21/2014,ULL,55,Arkansas St,40,15
10/23/2014,East Carolina,31,Connecticut,21,10
10/23/2014,Miami FL,30,Virginia Tech,6,24
10/24/2014,Cincinnati,34,South Florida,17,17
10/24/2014,South Alabama,27,Troy,13,14
10/24/2014,Oregon,59,California,41,18
10/24/2014,Boise St,55,BYU,30,25
10/25/2014,Ball St,35,Akron,21,14
10/25/2014,C Michigan,20,Buffalo,14,6
10/25/2014,Clemson,16,Syracuse,6,10
10/25/2014,N Illinois,28,E Michigan,17,11
10/25/2014,Ga Southern,69,Georgia St,31,38
10/25/2014,Illinois,28,Minnesota,24,4
10/25/2014,Mississippi St,45,Kentucky,31,14
10/25/2014,Marshall,35,FL Atlantic,16,19
10/25/2014,Miami OH,10,Kent,3,7
10/25/2014,Michigan St,35,Michigan,11,24
10/25/2014,Navy,41,San Jose St,31,10
10/25/2014,Georgia Tech,56,Pittsburgh,28,28
10/25/2014,Toledo,42,Massachusetts,35,7
10/25/2014,UCF,34,Temple,14,20
10/25/2014,North Carolina,28,Virginia,27,1
10/25/2014,Boston College,23,Wake Forest,17,6
10/25/2014,W Michigan,42,Ohio,21,21
10/25/2014,Wisconsin,52,Maryland,7,45
10/25/2014,Alabama,34,Tennessee,20,14
10/25/2014,Arkansas,45,UAB,17,28
10/25/2014,Kansas St,23,Texas,0,23
10/25/2014,LSU,10,Mississippi,7,3
10/25/2014,Nebraska,42,Rutgers,24,18
10/25/2014,West Virginia,34,Oklahoma St,10,24
10/25/2014,Rice,41,North Texas,21,20
10/25/2014,Memphis,48,SMU,10,38
10/25/2014,Louisiana Tech,31,Southern Miss,20,11
10/25/2014,TCU,82,Texas Tech,27,55
10/25/2014,UTEP,34,UT San Antonio,0,34
10/25/2014,WKU,66,Old Dominion,51,15
10/25/2014,Auburn,42,South Carolina,35,7
10/25/2014,Missouri,24,Vanderbilt,14,10
10/25/2014,Colorado St,45,Wyoming,31,14
10/25/2014,Utah St,34,UNLV,20,14
10/25/2014,UCLA,40,Colorado,37,3
10/25/2014,Utah,24,USC,21,3
10/25/2014,Stanford,38,Oregon St,14,24
10/25/2014,Arizona,59,Washington St,37,22
10/25/2014,Arizona St,24,Washington,10,14
10/25/2014,Nevada,26,Hawaii,18,8
10/25/2014,Texas St,22,ULM,18,4
10/25/2014,Ohio St,31,Penn St,24,7
10/30/2014,Ga Southern,42,Troy,10,32
10/30/2014,Florida St,42,Louisville,31,11
10/31/2014,Memphis,40,Tulsa,20,20
10/31/2014,Cincinnati,38,Tulane,14,24
11/1/2014,Appalachian St,44,Georgia St,0,44
11/1/2014,Air Force,23,Army,6,17
11/1/2014,C Michigan,38,E Michigan,7,31
11/1/2014,Rice,31,Florida Intl,17,14
11/1/2014,UAB,31,FL Atlantic,28,3
11/1/2014,Florida,38,Georgia,20,18
11/1/2014,Georgia Tech,35,Virginia,10,25
11/1/2014,Miami FL,47,North Carolina,20,27
11/1/2014,W Michigan,41,Miami OH,10,31
11/1/2014,Maryland,20,Penn St,19,1
11/1/2014,Tennessee,45,South Carolina,42,3
11/1/2014,Houston,27,South Florida,3,24
11/1/2014,NC State,24,Syracuse,17,7
11/1/2014,Temple,20,East Carolina,10,10
11/1/2014,Boston College,33,Virginia Tech,31,2
11/1/2014,TCU,31,West Virginia,30,1
11/1/2014,Connecticut,37,UCF,29,8
11/1/2014,Notre Dame,49,Navy,39,10
11/1/2014,Wisconsin,37,Rutgers,0,37
11/1/2014,Duke,51,Pittsburgh,48,3
11/1/2014,Baylor,60,Kansas,14,46
11/1/2014,Iowa,48,Northwestern,7,41
11/1/2014,ULL,19,South Alabama,9,10
11/1/2014,Louisiana Tech,59,WKU,10,49
11/1/2014,BYU,27,MTSU,7,20
11/1/2014,Mississippi St,17,Arkansas,10,7
11/1/2014,Missouri,20,Kentucky,10,10
11/1/2014,Nebraska,35,Purdue,14,21
11/1/2014,Texas A&M,21,ULM,16,5
11/1/2014,Texas,34,Texas Tech,13,21
11/1/2014,Vanderbilt,42,Old Dominion,28,14
11/1/2014,Auburn,35,Mississippi,31,4
11/1/2014,Oklahoma,59,Iowa St,14,45
11/1/2014,Kansas St,48,Oklahoma St,14,34
11/1/2014,UTEP,35,Southern Miss,14,21
11/1/2014,Washington,38,Colorado,23,15
11/1/2014,Arizona St,19,Utah,16,3
11/1/2014,Wyoming,45,Fresno St,17,28
11/1/2014,Arkansas St,44,Idaho,28,16
11/1/2014,California,45,Oregon St,31,14
11/1/2014,UCLA,17,Arizona,7,10
11/1/2014,New Mexico,31,UNLV,28,3
11/1/2014,Oregon,45,Stanford,16,29
11/1/2014,USC,44,Washington St,17,27
11/1/2014,Michigan,34,Indiana,10,24
11/1/2014,Utah St,35,Hawaii,14,21
11/1/2014,Colorado St,38,San Jose St,31,7
11/1/2014,Texas St,37,New Mexico St,29,8
11/1/2014,Ohio St,55,Illinois,14,41
11/1/2014,Nevada,30,San Diego St,14,16
11/4/2014,Bowling Green,27,Akron,10,17
11/4/2014,Toledo,30,Kent,20,10
11/5/2014,N Illinois,35,Ball St,21,14
11/5/2014,Ohio,37,Buffalo,14,23
11/6/2014,Clemson,34,Wake Forest,20,14
11/7/2014,Utah St,20,Wyoming,3,17
11/7/2014,Memphis,16,Temple,13,3
11/8/2014,Appalachian St,31,ULM,29,2
11/8/2014,Florida St,34,Virginia,20,14
11/8/2014,Penn St,13,Indiana,7,6
11/8/2014,Georgia,63,Kentucky,31,32
11/8/2014,Georgia Tech,56,NC State,23,33
11/8/2014,Old Dominion,38,Florida Intl,35,3
11/8/2014,Ohio St,49,Michigan St,37,12
11/8/2014,Louisville,38,Boston College,19,19
11/8/2014,Wisconsin,34,Purdue,16,18
11/8/2014,Duke,27,Syracuse,10,17
11/8/2014,Arkansas St,45,South Alabama,10,35
11/8/2014,Tulane,31,Houston,24,7
11/8/2014,Kansas,34,Iowa St,14,20
11/8/2014,Minnesota,51,Iowa,14,37
11/8/2014,Mississippi St,45,TN Martin,16,29
11/8/2014,North Texas,31,FL Atlantic,10,21
11/8/2014,Michigan,10,Northwestern,9,1
11/8/2014,Mississippi,48,Presbyterian,0,48
11/8/2014,Rice,17,UT San Antonio,7,10
11/8/2014,Marshall,63,Southern Miss,17,46
11/8/2014,TCU,41,Kansas St,20,21
11/8/2014,Texas,33,West Virginia,16,17
11/8/2014,Ga Southern,28,Texas St,25,3
11/8/2014,Troy,45,Georgia St,21,24
11/8/2014,Tulsa,38,SMU,28,10
11/8/2014,Louisiana Tech,40,UAB,24,16
11/8/2014,Florida,34,Vanderbilt,10,24
11/8/2014,WKU,35,UTEP,27,8
11/8/2014,Alabama,20,LSU,13,7
11/8/2014,Baylor,48,Oklahoma,14,34
11/8/2014,Texas A&M,41,Auburn,38,3
11/8/2014,Arizona,38,Colorado,20,18
11/8/2014,Colorado St,49,Hawaii,22,27
11/8/2014,Oregon,51,Utah,27,24
11/8/2014,Arizona St,55,Notre Dame,31,24
11/8/2014,Washington St,39,Oregon St,32,7
11/8/2014,San Diego St,35,Idaho,21,14
11/8/2014,Air Force,48,UNLV,21,27
11/8/2014,UCLA,44,Washington,30,14
11/8/2014,Army,35,Connecticut,21,14
11/8/2014,Boise St,60,New Mexico,49,11
11/8/2014,ULL,44,New Mexico St,16,28
11/8/2014,Fresno St,38,San Jose St,24,14
11/11/2014,Buffalo,55,Akron,24,31
11/11/2014,N Illinois,27,Toledo,24,3
11/12/2014,Bowling Green,30,Kent,20,10
11/12/2014,Massachusetts,24,Ball St,10,14
11/13/2014,UT San Antonio,12,Southern Miss,10,2
11/13/2014,USC,38,California,30,8
11/13/2014,Cincinnati,54,East Carolina,46,8
11/14/2014,UCF,31,Tulsa,7,24
11/15/2014,C Michigan,34,Miami OH,27,7
11/15/2014,Virginia Tech,17,Duke,16,1
11/15/2014,Florida Intl,38,MTSU,28,10
11/15/2014,Marshall,41,Rice,14,27
11/15/2014,Navy,52,Ga Southern,19,33
11/15/2014,North Carolina,40,Pittsburgh,35,5
11/15/2014,NC State,42,Wake Forest,13,29
11/15/2014,Penn St,30,Temple,13,17
11/15/2014,Rutgers,45,Indiana,23,22
11/15/2014,Tennessee,50,Kentucky,16,34
11/15/2014,W Michigan,51,E Michigan,7,44
11/15/2014,Florida St,30,Miami FL,26,4
11/15/2014,Georgia,34,Auburn,7,27
11/15/2014,South Carolina,23,Florida,20,3
11/15/2014,Georgia Tech,28,Clemson,6,22
11/15/2014,Alabama,25,Mississippi St,20,5
11/15/2014,Appalachian St,37,Arkansas St,32,5
11/15/2014,Iowa,30,Illinois,14,16
11/15/2014,TCU,34,Kansas,30,4
11/15/2014,Texas,28,Oklahoma St,7,21
11/15/2014,South Florida,14,SMU,13,1
11/15/2014,South Alabama,24,Texas St,20,4
11/15/2014,Memphis,38,Tulane,7,31
11/15/2014,WKU,52,Army,24,28
11/15/2014,Wisconsin,59,Nebraska,24,35
11/15/2014,Missouri,34,Texas A&M,27,7
11/15/2014,Oklahoma,42,Texas Tech,30,12
11/15/2014,Ohio St,31,Minnesota,24,7
11/15/2014,Arkansas,17,LSU,0,17
11/15/2014,Air Force,45,Nevada,38,7
11/15/2014,BYU,42,UNLV,23,19
11/15/2014,Boise St,38,San Diego St,29,9
11/15/2014,UTEP,35,North Texas,17,18
11/15/2014,Utah St,28,New Mexico,21,7
11/15/2014,Arizona,27,Washington,26,1
11/15/2014,Troy,34,Idaho,17,17
11/15/2014,Hawaii,13,San Jose St,0,13
11/15/2014,Utah,20,Stanford,17,3
11/15/2014,Oregon St,35,Arizona St,27,8
11/15/2014,Northwestern,43,Notre Dame,40,3
11/15/2014,ULL,34,ULM,27,7
11/15/2014,Michigan St,37,Maryland,15,22
11/18/2014,Akron,30,Massachusetts,6,24
11/18/2014,N Illinois,21,Ohio,14,7
11/19/2014,Toledo,27,Bowling Green,20,7
11/20/2014,Kansas St,26,West Virginia,20,6
11/20/2014,North Carolina,45,Duke,20,25
11/20/2014,Texas St,45,Arkansas St,27,18
11/21/2014,Rice,31,UTEP,13,18
11/21/2014,San Diego St,30,Air Force,14,16
11/21/2014,Utah St,41,San Jose St,7,34
11/22/2014,Army,42,Fordham,31,11
11/22/2014,Ball St,45,E Michigan,30,15
11/22/2014,W Michigan,32,C Michigan,20,12
11/22/2014,Clemson,28,Georgia St,0,28
11/22/2014,Cincinnati,41,Connecticut,0,41
11/22/2014,East Carolina,34,Tulane,6,28
11/22/2014,Florida,52,E Kentucky,3,49
11/22/2014,Florida St,20,Boston College,17,3
11/22/2014,Georgia,55,Charleston So,9,46
11/22/2014,Maryland,23,Michigan,16,7
11/22/2014,Michigan St,45,Rutgers,3,42
11/22/2014,Ohio St,42,Indiana,27,15
11/22/2014,Old Dominion,30,Louisiana Tech,27,3
11/22/2014,Pittsburgh,30,Syracuse,7,23
11/22/2014,Northwestern,38,Purdue,14,24
11/22/2014,South Carolina,37,South Alabama,12,25
11/22/2014,UCF,53,SMU,7,46
11/22/2014,Virginia,30,Miami FL,13,17
11/22/2014,Wake Forest,6,Virginia Tech,3,3
11/22/2014,Missouri,29,Tennessee,21,8
11/22/2014,Alabama,48,W Carolina,14,34
11/22/2014,Arkansas,30,Mississippi,0,30
11/22/2014,Auburn,31,Samford,7,24
11/22/2014,Houston,38,Tulsa,28,10
11/22/2014,Illinois,16,Penn St,14,2
11/22/2014,Texas Tech,34,Iowa St,31,3
11/22/2014,Appalachian St,35,ULL,16,19
11/22/2014,Memphis,31,South Florida,20,11
11/22/2014,MTSU,35,FL Atlantic,34,1
11/22/2014,Minnesota,28,Nebraska,24,4
11/22/2014,North Texas,17,Florida Intl,14,3
11/22/2014,Oklahoma,44,Kansas,7,37
11/22/2014,Marshall,23,UAB,18,5
11/22/2014,WKU,45,UT San Antonio,7,38
11/22/2014,Baylor,49,Oklahoma St,28,21
11/22/2014,Wisconsin,26,Iowa,24,2
11/22/2014,Mississippi St,51,Vanderbilt,0,51
11/22/2014,Arizona St,52,Washington St,31,21
11/22/2014,BYU,64,Savannah St,0,64
11/22/2014,Colorado St,58,New Mexico,20,38
11/22/2014,Arizona,42,Utah,10,32
11/22/2014,Boise St,63,Wyoming,14,49
11/22/2014,Fresno St,40,Nevada,20,20
11/22/2014,Oregon,44,Colorado,10,34
11/22/2014,Washington,37,Oregon St,13,24
11/22/2014,Stanford,38,California,17,21
11/22/2014,UCLA,38,USC,20,18
11/22/2014,Louisville,31,Notre Dame,28,3
11/22/2014,Hawaii,37,UNLV,35,2
11/22/2014,ULM,30,New Mexico St,17,13
11/25/2014,Ohio,24,Miami OH,21,3
11/27/2014,TCU,48,Texas,10,38
11/27/2014,LSU,23,Texas A&M,17,6
11/28/2014,Kent,27,Akron,24,3
11/28/2014,Ball St,41,Bowling Green,24,17
11/28/2014,Toledo,52,E Michigan,16,36
11/28/2014,WKU,67,Marshall,66,1
11/28/2014,Buffalo,41,Massachusetts,21,20
11/28/2014,Virginia Tech,24,Virginia,20,4
11/28/2014,N Illinois,31,W Michigan,21,10
11/28/2014,UCF,16,South Florida,0,16
11/28/2014,Nebraska,37,Iowa,34,3
11/28/2014,Houston,35,SMU,9,26
11/28/2014,Navy,42,South Alabama,40,2
11/28/2014,East Carolina,49,Tulsa,32,17
11/28/2014,Arizona,42,Arizona St,35,7
11/28/2014,Stanford,31,UCLA,10,21
11/28/2014,Air Force,27,Colorado St,24,3
11/28/2014,Missouri,21,Arkansas,14,7
11/29/2014,Appalachian St,45,Idaho,28,17
11/29/2014,Boston College,28,Syracuse,7,21
11/29/2014,Duke,41,Wake Forest,21,20
11/29/2014,Old Dominion,31,FL Atlantic,28,3
11/29/2014,Florida St,24,Florida,19,5
11/29/2014,Georgia Tech,30,Georgia,24,6
11/29/2014,Texas St,54,Georgia St,31,23
11/29/2014,Indiana,23,Purdue,16,7
11/29/2014,Louisville,44,Kentucky,40,4
11/29/2014,Rutgers,41,Maryland,38,3
11/29/2014,Pittsburgh,35,Miami FL,23,12
11/29/2014,NC State,35,North Carolina,7,28
11/29/2014,Ohio St,42,Michigan,28,14
11/29/2014,Cincinnati,14,Temple,6,8
11/29/2014,Michigan St,34,Penn St,10,24
11/29/2014,Clemson,35,South Carolina,17,18
11/29/2014,Arkansas St,68,New Mexico St,35,33
11/29/2014,Baylor,48,Texas Tech,46,2
11/29/2014,West Virginia,37,Iowa St,24,13
11/29/2014,Kansas St,51,Kansas,13,38
11/29/2014,Louisiana Tech,76,Rice,31,45
11/29/2014,Memphis,41,Connecticut,10,31
11/29/2014,Illinois,47,Northwestern,33,14
11/29/2014,Mississippi,31,Mississippi St,17,14
11/29/2014,UAB,45,Southern Miss,24,21
11/29/2014,ULL,42,Troy,23,19
11/29/2014,UT San Antonio,34,North Texas,27,7
11/29/2014,Tennessee,24,Vanderbilt,17,7
11/29/2014,Wisconsin,34,Minnesota,24,10
11/29/2014,Alabama,55,Auburn,44,11
11/29/2014,Boise St,50,Utah St,19,31
11/29/2014,Utah,38,Colorado,34,4
11/29/2014,New Mexico,36,Wyoming,30,6
11/29/2014,UTEP,24,MTSU,21,3
11/29/2014,BYU,42,California,35,7
11/29/2014,Fresno St,28,Hawaii,21,7
11/29/2014,Nevada,49,UNLV,27,22
11/29/2014,Oregon,47,Oregon St,19,28
11/29/2014,USC,49,Notre Dame,14,35
11/29/2014,Washington,31,Washington St,13,18
11/29/2014,San Diego St,38,San Jose St,7,31
11/29/2014,Ga Southern,22,ULM,16,6
12/4/2014,UCF,32,East Carolina,30,2
12/5/2014,N Illinois,51,Bowling Green,17,34
12/5/2014,Oregon,51,Arizona,13,38
12/6/2014,Cincinnati,38,Houston,31,7
12/6/2014,SMU,27,Connecticut,20,7
12/6/2014,Baylor,38,Kansas St,27,11
12/6/2014,TCU,55,Iowa St,3,52
12/6/2014,Temple,10,Tulane,3,7
12/6/2014,Oklahoma St,38,Oklahoma,35,3
12/6/2014,Alabama,42,Missouri,13,29
12/6/2014,Boise St,28,Fresno St,14,14
12/6/2014,Florida St,37,Georgia Tech,35,2
12/6/2014,Marshall,26,Louisiana Tech,23,3
12/6/2014,Ohio St,59,Wisconsin,0,59
12/13/2014,Navy,17,Army,10,7
12/20/2014,ULL,16,Nevada,3,13
12/20/2014,Utah St,21,UTEP,6,15
12/20/2014,Utah,45,Colorado St,10,35
12/20/2014,Air Force,38,W Michigan,24,14
12/20/2014,Bowling Green,33,South Alabama,28,5
12/22/2014,Memphis,55,BYU,48,7
12/23/2014,Marshall,52,N Illinois,23,29
12/23/2014,Navy,17,San Diego St,16,1
12/24/2014,WKU,49,C Michigan,48,1
12/24/2014,Rice,30,Fresno St,6,24
12/26/2014,Louisiana Tech,35,Illinois,35,0
12/26/2014,Rutgers,40,North Carolina,40,0
12/26/2014,NC State,34,UCF,34,0
12/27/2014,Virginia Tech,33,Cincinnati,17,16
12/27/2014,Arizona St,36,Duke,31,5
12/27/2014,South Carolina,24,Miami FL,21,3
12/27/2014,Penn St,31,Boston College,30,1
12/27/2014,USC,45,Nebraska,42,3
12/29/2014,Texas A&M,45,West Virginia,37,8
12/29/2014,Clemson,40,Oklahoma,6,34
12/29/2014,Arkansas,31,Texas,7,24
12/30/2014,Notre Dame,31,LSU,28,3
12/30/2014,Georgia,37,Louisville,14,23
12/30/2014,Stanford,45,Maryland,21,24
12/31/2014,TCU,42,Mississippi,3,39
12/31/2014,Boise St,38,Arizona,30,8
12/31/2014,Georgia Tech,49,Mississippi St,24,25
1/1/2015,Oregon,59,Florida St,20,39
1/1/2015,Ohio St,42,Alabama,35,7
1/1/2015,Wisconsin,34,Auburn,31,3
1/1/2015,Michigan St,42,Baylor,41,1
1/1/2015,Missouri,33,Minnesota,17,16
1/2/2015,Houston,35,Pittsburgh,34,1
1/2/2015,Tennessee,45,Iowa,28,17
1/2/2015,UCLA,40,Kansas St,35,5
1/2/2015,Oklahoma St,30,Washington,22,8
1/3/2015,Florida,28,East Carolina,20,8
1/4/2015,Toledo,63,Arkansas St,44,19
1/12/2015,Ohio St,42,Oregon,20,22
